changeyear,cntyfp,geoid,baseyear,lastgeyear,changenopolls,nopollsadded,nopollsremoved,baseyearpctblack,baseyearpcthispanic,baseyearpctwhite,baseyearpopdensity,lastgeyearpollinglocstotal,baseyearpollinglocstotal,lastgeyeartotalpop,baseyeartotalpop,lastgeyearpopperpoll,baseyearpopperpoll,lastgeyearcvap,baseyearcvap,lastgeyearcvapperpoll,baseyearcvapperpoll,changeyearpopperpoll,changeyearcvapperpoll
2016 - 2018,13001,13001,2018,2016,5,4,1,0.182,0.098,0.694,36.309,9,12,18410,18455,2045,1537,13180,13465,1464,1122,508,342
2018 - 2020,13001,13001,2020,2018,5,1,4,0.198,0.100,0.690,36.260,12,9,18455,18430,1537,2047,13465,13275,1122,1475,510,353
2020 - 2022,13001,13001,2022,2020,5,2,3,0.182,0.103,0.684,36.280,9,8,18430,18440,2047,2305,13275,13090,1475,1636,258,161
2016 - 2018,13003,13003,2018,2016,0,0,0,0.178,0.246,0.569,24.116,4,4,8270,8265,2067,2066,5150,5190,1287,1297,1,10
2018 - 2020,13003,13003,2020,2018,0,0,0,0.155,0.259,0.558,24.247,4,4,8265,8310,2066,2077,5190,5215,1297,1303,11,6
2020 - 2022,13003,13003,2022,2020,2,1,1,0.152,0.273,0.546,24.116,4,4,8310,8265,2077,2066,5215,5205,1303,1301,11,2
2016 - 2018,13005,13005,2018,2016,4,4,0,0.157,0.084,0.735,39.530,1,5,11250,11230,11250,2246,7895,8030,7895,1606,9004,6289
2018 - 2020,13005,13005,2020,2018,4,0,4,0.164,0.084,0.732,39.214,5,1,11230,11140,2246,11140,8030,8055,1606,8055,8894,6449
2020 - 2022,13005,13005,2022,2020,0,0,0,0.158,0.087,0.728,39.214,1,1,11140,11140,11140,11140,8055,8055,8055,8055,0,0
2016 - 2018,13007,13007,2018,2016,6,1,5,0.386,0.042,0.534,9.329,5,1,3250,3190,650,3190,2565,2475,513,2475,2540,1962
2018 - 2020,13007,13007,2020,2018,0,0,0,0.380,0.045,0.502,9.036,1,1,3190,3090,3190,3090,2475,2485,2475,2485,100,10
2020 - 2022,13007,13007,2022,2020,8,7,1,0.345,0.009,0.523,8.422,1,7,3090,2880,3090,411,2485,2280,2485,325,2679,2160
2016 - 2018,13009,13009,2018,2016,0,0,0,0.420,0.022,0.527,175.049,14,14,45810,45285,3272,3234,36225,35845,2587,2560,38,27
2018 - 2020,13009,13009,2020,2018,0,0,0,0.418,0.024,0.523,174.218,14,14,45285,45070,3234,3219,35845,36070,2560,2576,15,16
2020 - 2022,13009,13009,2022,2020,1,1,0,0.415,0.026,0.521,169.231,14,15,45070,43780,3219,2918,36070,35055,2576,2337,301,239
2016 - 2018,13011,13011,2018,2016,9,8,1,0.027,0.067,0.881,79.765,6,13,18335,18510,3055,1423,13590,13670,2265,1051,1632,1214
2018 - 2020,13011,13011,2020,2018,2,1,1,0.022,0.070,0.876,81.250,13,13,18510,18900,1423,1453,13670,14020,1051,1078,30,27
2020 - 2022,13011,13011,2022,2020,15,2,13,0.029,0.077,0.865,79.014,13,2,18900,18380,1453,9190,14020,13870,1078,6935,7737,5857
2016 - 2018,13013,13013,2018,2016,12,10,2,0.115,0.104,0.724,477.439,8,16,73340,76885,9167,4805,50790,53645,6348,3352,4362,2996
2018 - 2020,13013,13013,2020,2018,0,0,0,0.121,0.115,0.702,504.823,16,16,76885,81295,4805,5080,53645,57015,3352,3563,275,211
2020 - 2022,13013,13013,2022,2020,17,5,12,0.126,0.132,0.674,524.104,16,9,81295,84400,5080,9377,57015,59865,3563,6651,4297,3088
2016 - 2018,13015,13015,2018,2016,4,2,2,0.108,0.083,0.781,225.496,17,17,101940,103620,5996,6095,72800,74245,4282,4367,99,85
2018 - 2020,13015,13015,2020,2018,3,1,2,0.101,0.089,0.772,231.974,17,16,103620,106455,6095,6653,74245,77890,4367,4868,558,501
2020 - 2022,13015,13015,2022,2020,2,2,0,0.106,0.096,0.762,238.413,16,18,106455,109410,6653,6078,77890,80885,4868,4493,575,375
2016 - 2018,13017,13017,2018,2016,4,3,1,0.366,0.061,0.563,68.586,1,3,17405,17155,17405,5718,12550,12435,12550,4145,11687,8405
2018 - 2020,13017,13017,2020,2018,1,0,1,0.369,0.062,0.553,67.528,3,2,17155,16890,5718,8445,12435,12300,4145,6150,2727,2005
2020 - 2022,13017,13017,2022,2020,3,1,2,0.375,0.065,0.545,68.648,2,1,16890,17170,8445,17170,12300,12640,6150,12640,8725,6490
2016 - 2018,13019,13019,2018,2016,0,0,0,0.111,0.049,0.822,41.963,5,5,18985,19025,3797,3805,13985,14100,2797,2820,8,23
2018 - 2020,13019,13019,2020,2018,0,0,0,0.100,0.053,0.816,42.360,5,5,19025,19205,3805,3841,14100,14320,2820,2864,36,44
2020 - 2022,13019,13019,2022,2020,2,1,1,0.103,0.057,0.806,40.110,5,5,19205,18185,3841,3637,14320,13705,2864,2741,204,123
2016 - 2018,13021,13021,2018,2016,19,10,9,0.541,0.032,0.388,615.441,31,32,154195,153490,4974,4796,112570,113415,3631,3544,178,87
2018 - 2020,13021,13021,2020,2018,11,5,6,0.546,0.034,0.378,613.615,32,31,153490,153025,4796,4936,113415,113835,3544,3672,140,128
2020 - 2022,13021,13021,2022,2020,16,9,7,0.547,0.037,0.366,627.770,31,33,153025,156555,4936,4744,113835,116915,3672,3542,192,130
2016 - 2018,13023,13023,2018,2016,4,2,2,0.279,0.028,0.688,59.179,2,2,12835,12775,6417,6387,9900,9905,4950,4952,30,2
2018 - 2020,13023,13023,2020,2018,0,0,0,0.282,0.031,0.681,59.619,2,2,12775,12870,6387,6435,9905,10230,4952,5115,48,163
2020 - 2022,13023,13023,2022,2020,5,3,2,0.262,0.034,0.687,57.509,2,3,12870,12415,6435,4138,10230,9925,5115,3308,2297,1807
2016 - 2018,13025,13025,2018,2016,0,0,0,0.031,0.021,0.925,41.895,2,2,18405,18560,9202,9280,13650,13945,6825,6972,78,147
2018 - 2020,13025,13025,2020,2018,0,0,0,0.033,0.023,0.919,42.697,2,2,18560,18925,9280,9462,13945,14215,6972,7107,182,135
2020 - 2022,13025,13025,2022,2020,3,2,1,0.037,0.026,0.913,40.847,2,3,18925,18105,9462,6035,14215,13665,7107,4555,3427,2552
2016 - 2018,13027,13027,2018,2016,2,1,1,0.341,0.057,0.569,31.677,7,7,15645,15620,2235,2231,11765,11730,1680,1675,4,5
2018 - 2020,13027,13027,2020,2018,0,0,0,0.355,0.059,0.564,31.530,7,7,15620,15550,2231,2221,11730,11815,1675,1687,10,12
2020 - 2022,13027,13027,2022,2020,5,3,2,0.345,0.076,0.550,33.000,7,8,15550,16275,2221,2034,11815,12540,1687,1567,187,120
2016 - 2018,13029,13029,2018,2016,4,2,2,0.142,0.068,0.739,82.013,10,10,34105,35885,3410,3588,23490,24670,2349,2467,178,118
2018 - 2020,13029,13029,2020,2018,2,1,1,0.140,0.075,0.728,87.576,10,10,35885,38320,3588,3832,24670,26345,2467,2634,244,167
2020 - 2022,13029,13029,2022,2020,7,4,3,0.139,0.082,0.715,102.831,10,11,38320,44995,3832,4090,26345,31115,2634,2828,258,194
2016 - 2018,13031,13031,2018,2016,9,4,5,0.281,0.039,0.639,110.630,16,15,73140,74780,4571,4985,57220,58410,3576,3894,414,318
2018 - 2020,13031,13031,2020,2018,0,0,0,0.279,0.042,0.634,114.977,15,15,74780,77720,4985,5181,58410,60400,3894,4026,196,132
2020 - 2022,13031,13031,2022,2020,6,4,2,0.276,0.044,0.630,118.098,15,17,77720,79830,5181,4695,60400,62385,4026,3669,486,357
2016 - 2018,13033,13033,2018,2016,2,1,1,0.490,0.031,0.472,27.266,15,15,22840,22550,1522,1503,16535,16390,1102,1092,19,10
2018 - 2020,13033,13033,2020,2018,2,1,1,0.477,0.032,0.475,27.284,15,15,22550,22565,1503,1504,16390,16520,1092,1101,1,9
2020 - 2022,13033,13033,2022,2020,2,1,1,0.460,0.036,0.479,29.424,15,15,22565,24335,1504,1622,16520,17950,1101,1196,118,95
2016 - 2018,13035,13035,2018,2016,6,5,1,0.287,0.032,0.668,129.294,2,6,23480,23750,11740,3958,18030,18545,9015,3090,7782,5925
2018 - 2020,13035,13035,2020,2018,6,1,5,0.283,0.034,0.662,133.186,6,2,23750,24465,3958,12232,18545,19115,3090,9557,8274,6467
2020 - 2022,13035,13035,2022,2020,5,5,0,0.277,0.037,0.658,138.930,2,7,24465,25520,12232,3645,19115,20070,9557,2867,8587,6690
2016 - 2018,13037,13037,2018,2016,2,1,1,0.612,0.047,0.326,22.933,3,3,6445,6430,2148,2143,5035,5090,1678,1696,5,18
2018 - 2020,13037,13037,2020,2018,2,1,1,0.606,0.050,0.325,22.469,3,3,6430,6300,2143,2100,5090,4990,1696,1663,43,33
2020 - 2022,13037,13037,2022,2020,3,2,1,0.619,0.056,0.318,19.955,3,4,6300,5595,2100,1398,4990,4480,1663,1120,702,543
2016 - 2018,13039,13039,2018,2016,14,7,7,0.187,0.066,0.700,83.635,12,12,52090,52715,4340,4392,37995,38500,3166,3208,52,42
2018 - 2020,13039,13039,2020,2018,0,0,0,0.178,0.070,0.696,85.602,12,12,52715,53960,4392,4496,38500,39845,3208,3320,104,112
2020 - 2022,13039,13039,2022,2020,17,9,8,0.171,0.075,0.693,87.430,12,13,53960,55105,4496,4238,39845,41315,3320,3178,258,142
2016 - 2018,13043,13043,2018,2016,0,0,0,0.235,0.115,0.621,44.536,1,1,10960,10825,10960,10825,7815,7755,7815,7755,135,60
2018 - 2020,13043,13043,2020,2018,0,0,0,0.249,0.117,0.617,44.578,1,1,10825,10835,10825,10835,7755,7590,7755,7590,10,165
2020 - 2022,13043,13043,2022,2020,0,0,0,0.222,0.122,0.609,45.030,1,1,10835,10945,10835,10945,7590,7565,7590,7565,110,25
2016 - 2018,13045,13045,2018,2016,14,8,6,0.190,0.068,0.713,232.492,25,27,113755,116020,4550,4297,83470,85275,3338,3158,253,180
2018 - 2020,13045,13045,2020,2018,12,5,7,0.197,0.070,0.707,237.792,27,25,116020,118690,4297,4747,85275,87100,3158,3484,450,326
2020 - 2022,13045,13045,2022,2020,6,3,3,0.200,0.075,0.699,240.536,25,25,118690,120060,4747,4802,87100,88135,3484,3525,55,41
2016 - 2018,13047,13047,2018,2016,0,0,0,0.022,0.029,0.912,408.849,11,11,65645,66300,5967,6027,49385,50100,4489,4554,60,65
2018 - 2020,13047,13047,2020,2018,0,0,0,0.021,0.030,0.907,414.276,11,11,66300,67180,6027,6107,50100,51145,4554,4649,80,95
2020 - 2022,13047,13047,2022,2020,4,2,2,0.023,0.034,0.900,419.641,11,11,67180,68050,6107,6186,51145,52345,4649,4758,79,109
2016 - 2018,13049,13049,2018,2016,0,0,0,0.255,0.085,0.615,16.646,8,8,12970,12985,1621,1623,9395,9385,1174,1173,2,1
2018 - 2020,13049,13049,2020,2018,0,0,0,0.260,0.072,0.613,16.703,8,8,12985,13030,1623,1628,9385,9770,1173,1221,5,48
2020 - 2022,13049,13049,2022,2020,5,2,3,0.286,0.060,0.605,16.082,8,7,13030,12545,1628,1792,9770,9890,1221,1412,164,191
2016 - 2018,13051,13051,2018,2016,19,8,11,0.394,0.063,0.490,662.744,91,88,282615,287050,3105,3261,210415,214575,2312,2438,156,126
2018 - 2020,13051,13051,2020,2018,3,2,1,0.399,0.065,0.482,668.754,88,89,287050,289650,3261,3254,214575,218675,2438,2457,7,19
2020 - 2022,13051,13051,2022,2020,72,38,34,0.399,0.068,0.476,684.028,89,93,289650,296265,3254,3185,218675,225415,2457,2423,69,34
2016 - 2018,13053,13053,2018,2016,0,0,0,0.201,0.154,0.587,43.279,1,1,11880,10765,11880,10765,8765,8230,8765,8230,1115,535
2018 - 2020,13053,13053,2020,2018,0,0,0,0.203,0.162,0.575,42.093,1,1,10765,10470,10765,10470,8230,8145,8230,8145,295,85
2020 - 2022,13053,13053,2022,2020,1,1,0,0.161,0.176,0.563,37.791,1,2,10470,9400,10470,4700,8145,7205,8145,3602,5770,4543
2016 - 2018,13055,13055,2018,2016,11,8,3,0.103,0.050,0.829,79.198,7,12,25045,24815,3577,2067,18950,18685,2707,1557,1510,1150
2018 - 2020,13055,13055,2020,2018,2,1,1,0.096,0.053,0.826,79.230,12,12,24815,24825,2067,2068,18685,18605,1557,1550,1,7
2020 - 2022,13055,13055,2022,2020,12,4,8,0.095,0.057,0.822,79.470,12,8,24825,24900,2068,3112,18605,18825,1550,2353,1044,803
2016 - 2018,13057,13057,2018,2016,18,10,8,0.063,0.103,0.796,574.495,40,42,230630,241910,5765,5759,158990,169345,3974,4032,6,58
2018 - 2020,13057,13057,2020,2018,3,1,2,0.068,0.107,0.785,602.685,42,41,241910,253780,5759,6189,169345,179495,4032,4377,430,345
2020 - 2022,13057,13057,2022,2020,23,12,11,0.070,0.112,0.773,637.797,41,42,253780,268565,6189,6394,179495,191790,4377,4566,205,189
2016 - 2018,13059,13059,2018,2016,5,1,4,0.274,0.107,0.555,1045.140,24,21,122035,124600,5084,5933,92700,94990,3862,4523,849,661
2018 - 2020,13059,13059,2020,2018,3,1,2,0.280,0.108,0.553,1064.816,21,20,124600,126950,5933,6347,94990,97560,4523,4878,414,355
2020 - 2022,13059,13059,2022,2020,11,9,2,0.264,0.110,0.554,1080.176,20,27,126950,128865,6347,4772,97560,99885,4878,3699,1575,1179
2016 - 2018,13061,13061,2018,2016,0,0,0,0.682,0.000,0.303,15.353,1,1,3070,3000,3070,3000,2315,2395,2315,2395,70,80
2018 - 2020,13061,13061,2020,2018,0,0,0,0.556,0.003,0.427,14.995,1,1,3000,2930,3000,2930,2395,2335,2395,2335,70,60
2020 - 2022,13061,13061,2022,2020,0,0,0,0.615,0.004,0.364,14.611,1,1,2930,2855,2930,2855,2335,2170,2335,2170,75,165
2016 - 2018,13063,13063,2018,2016,17,5,12,0.686,0.132,0.108,1966.966,65,58,270270,278665,4158,4804,173345,182055,2666,3138,646,472
2018 - 2020,13063,13063,2020,2018,2,1,1,0.695,0.132,0.096,2030.034,58,58,278665,287560,4804,4957,182055,189560,3138,3268,153,130
2020 - 2022,13063,13063,2022,2020,50,33,17,0.696,0.134,0.087,2090.288,58,74,287560,296310,4957,4004,189560,197730,3268,2672,953,596
2016 - 2018,13065,13065,2018,2016,2,1,1,0.277,0.051,0.653,8.276,4,4,6815,6745,1703,1686,4820,4810,1205,1202,17,3
2018 - 2020,13065,13065,2020,2018,0,0,0,0.251,0.060,0.650,8.160,4,4,6745,6650,1686,1662,4810,4885,1202,1221,24,19
2020 - 2022,13065,13065,2022,2020,4,2,2,0.265,0.057,0.646,8.239,4,4,6650,6715,1662,1678,4885,4760,1221,1190,16,31
2016 - 2018,13067,13067,2018,2016,88,43,45,0.268,0.128,0.527,2192.910,145,143,728390,745055,5023,5210,487960,506705,3365,3543,187,178
2018 - 2020,13067,13067,2020,2018,14,6,8,0.270,0.130,0.517,2226.895,143,141,745055,756655,5210,5366,506705,523075,3543,3709,156,166
2020 - 2022,13067,13067,2022,2020,127,67,60,0.273,0.135,0.507,2253.874,141,148,756655,765815,5366,5174,523075,535160,3709,3615,192,94
2016 - 2018,13069,13069,2018,2016,0,0,0,0.282,0.115,0.586,72.531,6,6,43040,42960,7173,7160,30690,30865,5115,5144,13,29
2018 - 2020,13069,13069,2020,2018,0,0,0,0.286,0.117,0.578,72.720,6,6,42960,43070,7160,7178,30865,30945,5144,5157,18,13
2020 - 2022,13069,13069,2022,2020,1,1,0,0.288,0.123,0.572,72.698,6,7,43070,43055,7178,6150,30945,30875,5157,4410,1028,747
2016 - 2018,13071,13071,2018,2016,0,0,0,0.228,0.190,0.563,83.369,19,19,46000,45605,2421,2400,29675,29860,1561,1571,21,10
2018 - 2020,13071,13071,2020,2018,0,0,0,0.234,0.194,0.554,83.194,19,19,45605,45510,2400,2395,29860,30550,1571,1607,5,36
2020 - 2022,13071,13071,2022,2020,9,5,4,0.227,0.201,0.546,83.752,19,20,45510,45815,2395,2290,30550,30505,1607,1525,105,82
2016 - 2018,13073,13073,2018,2016,19,9,10,0.167,0.064,0.697,507.781,47,46,139905,147295,2976,3202,99705,104945,2121,2281,226,160
2018 - 2020,13073,13073,2020,2018,6,3,3,0.170,0.069,0.680,531.564,46,46,147295,154255,3202,3353,104945,110805,2281,2408,151,127
2020 - 2022,13073,13073,2022,2020,20,13,7,0.176,0.073,0.663,540.742,46,52,154255,156920,3353,3017,110805,113580,2408,2184,336,224
2016 - 2018,13075,13075,2018,2016,0,0,0,0.274,0.058,0.649,75.281,6,6,17105,17185,2850,2864,12215,12425,2035,2070,14,35
2018 - 2020,13075,13075,2020,2018,0,0,0,0.273,0.058,0.644,75.355,6,6,17185,17215,2864,2869,12425,12535,2070,2089,5,19
2020 - 2022,13075,13075,2022,2020,1,1,0,0.270,0.066,0.633,75.465,6,7,17215,17240,2869,2462,12535,12505,2089,1786,407,303
2016 - 2018,13077,13077,2018,2016,13,8,5,0.174,0.068,0.716,318.677,26,29,135625,140515,5216,4845,96460,100665,3710,3471,371,239
2018 - 2020,13077,13077,2020,2018,7,3,4,0.174,0.071,0.709,330.651,29,28,140515,145840,4845,5208,100665,105490,3471,3767,363,296
2020 - 2022,13077,13077,2022,2020,9,4,5,0.178,0.076,0.697,334.300,28,27,145840,147450,5208,5461,105490,108260,3767,4009,253,242
2016 - 2018,13079,13079,2018,2016,8,4,4,0.241,0.013,0.735,37.995,6,6,12485,12345,2080,2057,9700,9705,1616,1617,23,1
2018 - 2020,13079,13079,2020,2018,4,2,2,0.221,0.035,0.733,37.748,6,6,12345,12265,2057,2044,9705,9740,1617,1623,13,6
2020 - 2022,13079,13079,2022,2020,3,1,2,0.220,0.039,0.726,37.410,6,5,12265,12155,2044,2431,9740,9580,1623,1916,387,293
2016 - 2018,13081,13081,2018,2016,4,2,2,0.437,0.033,0.503,83.785,5,5,23060,22845,4612,4569,17040,16755,3408,3351,43,57
2018 - 2020,13081,13081,2020,2018,0,0,0,0.458,0.035,0.498,82.551,5,5,22845,22510,4569,4502,16755,16915,3351,3383,67,32
2020 - 2022,13081,13081,2022,2020,5,3,2,0.448,0.040,0.490,74.281,5,6,22510,20255,4502,3375,16915,15340,3383,2556,1127,827
2016 - 2018,13083,13083,2018,2016,3,1,2,0.004,0.022,0.940,93.258,5,4,16355,16225,3271,4056,13035,13030,2607,3257,785,650
2018 - 2020,13083,13083,2020,2018,3,2,1,0.009,0.023,0.936,93.032,4,5,16225,16185,4056,3237,13030,12945,3257,2589,819,668
2020 - 2022,13083,13083,2022,2020,1,1,0,0.010,0.026,0.931,93.293,5,6,16185,16240,3237,2706,12945,12875,2589,2145,531,444
2016 - 2018,13085,13085,2018,2016,0,0,0,0.010,0.044,0.926,113.173,3,3,22940,23860,7646,7953,17615,18590,5871,6196,307,325
2018 - 2020,13085,13085,2020,2018,0,0,0,0.007,0.049,0.918,119.884,3,3,23860,25275,7953,8425,18590,20040,6196,6680,472,484
2020 - 2022,13085,13085,2022,2020,0,0,0,0.013,0.058,0.903,129.750,3,3,25275,27355,8425,9118,20040,21570,6680,7190,693,510
2016 - 2018,13087,13087,2018,2016,2,1,1,0.425,0.059,0.505,44.937,9,9,27235,26835,3026,2981,19875,19695,2208,2188,45,20
2018 - 2020,13087,13087,2020,2018,0,0,0,0.427,0.061,0.499,44.530,9,9,26835,26595,2981,2955,19695,19565,2188,2173,26,15
2020 - 2022,13087,13087,2022,2020,4,3,1,0.414,0.067,0.494,48.666,9,11,26595,29065,2955,2642,19565,21460,2173,1950,313,223
2016 - 2018,13089,13089,2018,2016,42,26,16,0.537,0.086,0.292,2775.921,165,175,723900,743185,4387,4246,489315,506820,2965,2896,141,69
2018 - 2020,13089,13089,2020,2018,19,8,11,0.533,0.084,0.293,2820.962,175,172,743185,755285,4246,4391,506820,522340,2896,3036,145,140
2020 - 2022,13089,13089,2022,2020,71,36,35,0.531,0.085,0.293,2844.190,172,173,755285,761210,4391,4400,522340,532965,3036,3080,9,44
2016 - 2018,13091,13091,2018,2016,21,7,14,0.281,0.035,0.653,42.181,14,7,20995,20920,1499,2988,16285,16500,1163,2357,1489,1194
2018 - 2020,13091,13091,2020,2018,0,0,0,0.299,0.037,0.647,41.787,7,7,20920,20725,2988,2960,16500,16520,2357,2360,28,3
2020 - 2022,13091,13091,2022,2020,22,15,7,0.304,0.041,0.641,40.275,7,15,20725,19975,2960,1331,16520,15875,2360,1058,1629,1302
2016 - 2018,13093,13093,2018,2016,4,2,2,0.491,0.069,0.426,35.415,5,5,14090,13905,2818,2781,10955,11020,2191,2204,37,13
2018 - 2020,13093,13093,2020,2018,0,0,0,0.497,0.070,0.424,34.562,5,5,13905,13570,2781,2714,11020,10820,2204,2164,67,40
2020 - 2022,13093,13093,2022,2020,4,2,2,0.478,0.074,0.420,28.615,5,5,13570,11235,2714,2247,10820,9070,2164,1814,467,350
2016 - 2018,13095,13095,2018,2016,4,2,2,0.689,0.027,0.257,277.048,28,28,92325,91050,3297,3251,68025,67750,2429,2419,46,10
2018 - 2020,13095,13095,2020,2018,2,1,1,0.695,0.029,0.248,269.882,28,28,91050,88695,3251,3167,67750,66380,2419,2370,84,49
2020 - 2022,13095,13095,2022,2020,22,11,11,0.698,0.032,0.241,258.760,28,28,88695,85040,3167,3037,66380,63495,2370,2267,130,103
2016 - 2018,13097,13097,2018,2016,14,7,7,0.452,0.094,0.420,708.859,25,25,138285,141840,5531,5673,95670,99305,3826,3972,142,146
2018 - 2020,13097,13097,2020,2018,6,3,3,0.469,0.099,0.390,724.825,25,25,141840,145065,5673,5802,99305,102085,3972,4083,129,111
2020 - 2022,13097,13097,2022,2020,19,11,8,0.484,0.107,0.356,723.249,25,28,145065,144735,5802,5169,102085,101650,4083,3630,633,453
2016 - 2018,13099,13099,2018,2016,0,0,0,0.509,0.022,0.457,20.191,5,5,10480,10350,2096,2070,7760,7660,1552,1532,26,20
2018 - 2020,13099,13099,2020,2018,0,0,0,0.502,0.023,0.446,19.938,5,5,10350,10220,2070,2044,7660,7620,1532,1524,26,8
2020 - 2022,13099,13099,2022,2020,0,0,0,0.526,0.021,0.439,20.981,5,5,10220,10755,2044,2151,7620,8035,1524,1607,107,83
2016 - 2018,13101,13101,2018,2016,0,0,0,0.036,0.247,0.676,9.503,1,1,4025,3995,4025,3995,2415,2960,2415,2960,30,545
2018 - 2020,13101,13101,2020,2018,0,0,0,0.035,0.281,0.651,9.384,1,1,3995,3945,3995,3945,2960,2875,2960,2875,50,85
2020 - 2022,13101,13101,2022,2020,1,1,0,0.042,0.310,0.610,8.813,1,2,3945,3705,3945,1852,2875,2650,2875,1325,2093,1550
2016 - 2018,13103,13103,2018,2016,8,4,4,0.135,0.042,0.790,122.579,17,17,55850,58690,3285,3452,39795,42165,2340,2480,167,140
2018 - 2020,13103,13103,2020,2018,4,2,2,0.137,0.047,0.781,129.984,17,17,58690,62240,3452,3661,42165,44755,2480,2632,209,152
2020 - 2022,13103,13103,2022,2020,10,7,3,0.136,0.055,0.767,136.406,17,21,62240,65315,3661,3110,44755,47265,2632,2250,551,382
2016 - 2018,13105,13105,2018,2016,4,2,2,0.305,0.056,0.636,54.714,11,11,19395,19210,1763,1746,14780,14690,1343,1335,17,8
2018 - 2020,13105,13105,2020,2018,0,0,0,0.293,0.058,0.636,54.585,11,11,19210,19165,1746,1742,14690,14790,1335,1344,4,9
2020 - 2022,13105,13105,2022,2020,4,2,2,0.272,0.062,0.633,55.739,11,11,19165,19570,1742,1779,14790,14980,1344,1361,37,17
2016 - 2018,13107,13107,2018,2016,0,0,0,0.342,0.045,0.594,33.060,10,10,22725,22500,2272,2250,16910,16525,1691,1652,22,39
2018 - 2020,13107,13107,2020,2018,0,0,0,0.334,0.046,0.592,33.097,10,10,22500,22525,2250,2252,16525,16525,1652,1652,2,0
2020 - 2022,13107,13107,2022,2020,1,1,0,0.317,0.048,0.588,33.655,10,11,22525,22905,2252,2082,16525,16715,1652,1519,170,133
2016 - 2018,13109,13109,2018,2016,0,0,0,0.303,0.117,0.565,58.640,1,1,10735,10725,10735,10725,7545,7550,7545,7550,10,5
2018 - 2020,13109,13109,2020,2018,0,0,0,0.285,0.118,0.563,58.340,1,1,10725,10670,10725,10670,7550,7450,7550,7450,55,100
2020 - 2022,13109,13109,2022,2020,1,1,0,0.274,0.121,0.558,58.832,1,2,10670,10760,10670,5380,7450,7495,7450,3747,5290,3703
2016 - 2018,13111,13111,2018,2016,2,1,1,0.003,0.023,0.951,64.401,12,12,24015,24925,2001,2077,19625,20515,1635,1709,76,74
2018 - 2020,13111,13111,2020,2018,0,0,0,0.005,0.025,0.947,66.636,12,12,24925,25795,2077,2149,20515,21355,1709,1779,72,70
2020 - 2022,13111,13111,2022,2020,3,2,1,0.008,0.028,0.940,65.706,12,13,25795,25435,2149,1956,21355,21165,1779,1628,193,151
2016 - 2018,13113,13113,2018,2016,4,2,2,0.223,0.072,0.633,572.975,35,35,109495,111370,3128,3182,78815,80750,2251,2307,54,56
2018 - 2020,13113,13113,2020,2018,0,0,0,0.238,0.073,0.615,583.599,35,35,111370,113545,3182,3244,80750,82620,2307,2360,62,53
2020 - 2022,13113,13113,2022,2020,13,7,6,0.249,0.077,0.595,612.951,35,36,113545,119260,3244,3312,82620,86990,2360,2416,68,56
2016 - 2018,13115,13115,2018,2016,2,1,1,0.143,0.108,0.717,189.919,24,24,96200,96825,4008,4034,68655,69690,2860,2903,26,43
2018 - 2020,13115,13115,2020,2018,2,1,1,0.139,0.113,0.709,191.846,24,24,96825,97805,4034,4075,69690,70630,2903,2942,41,39
2020 - 2022,13115,13115,2022,2020,10,4,6,0.139,0.118,0.702,193.283,24,22,97805,98540,4075,4479,70630,71870,2942,3266,404,324
2016 - 2018,13117,13117,2018,2016,8,2,6,0.032,0.095,0.735,979.197,20,16,203840,219880,10192,13742,129230,139270,6461,8704,3550,2243
2018 - 2020,13117,13117,2020,2018,3,1,2,0.034,0.094,0.702,1053.367,16,15,219880,236605,13742,15773,139270,150515,8704,10034,2031,1330
2020 - 2022,13117,13117,2022,2020,21,18,3,0.040,0.096,0.671,1127.358,15,30,236605,253225,15773,8440,150515,162535,10034,5417,7333,4617
2016 - 2018,13119,13119,2018,2016,4,2,2,0.095,0.045,0.837,86.079,7,7,22190,22515,3170,3216,16770,17005,2395,2429,46,34
2018 - 2020,13119,13119,2020,2018,0,0,0,0.089,0.049,0.831,88.062,7,7,22515,23015,3216,3287,17005,17590,2429,2512,71,83
2020 - 2022,13119,13119,2022,2020,9,5,4,0.092,0.053,0.822,89.844,7,8,23015,23480,3287,2935,17590,17685,2512,2210,352,302
2016 - 2018,13121,13121,2018,2016,151,50,101,0.438,0.073,0.400,1940.049,256,205,996755,1021900,3893,4984,699145,722100,2731,3522,1091,791
2018 - 2020,13121,13121,2020,2018,52,17,35,0.434,0.072,0.397,1996.507,205,187,1021900,1051550,4984,5623,722100,753090,3522,4027,639,505
2020 - 2022,13121,13121,2022,2020,201,135,66,0.434,0.073,0.391,2015.956,187,256,1051550,1061945,5623,4148,753090,772350,4027,3016,1475,1011
2016 - 2018,13123,13123,2018,2016,2,1,1,0.003,0.115,0.861,70.200,13,13,28955,29920,2227,2301,21470,22475,1651,1728,74,77
2018 - 2020,13123,13123,2020,2018,2,1,1,0.002,0.117,0.858,72.698,13,13,29920,30985,2301,2383,22475,23940,1728,1841,82,113
2020 - 2022,13123,13123,2022,2020,3,2,1,0.005,0.124,0.847,73.953,13,14,30985,31520,2383,2251,23940,24795,1841,1771,132,70
2016 - 2018,13125,13125,2018,2016,0,0,0,0.091,0.017,0.874,20.940,4,4,3055,3010,763,752,2285,2300,571,575,11,4
2018 - 2020,13125,13125,2020,2018,0,0,0,0.097,0.017,0.873,20.766,4,4,3010,2985,752,746,2300,2325,575,581,6,6
2020 - 2022,13125,13125,2022,2020,0,0,0,0.105,0.012,0.871,20.209,4,4,2985,2905,746,726,2325,2280,581,570,20,11
2016 - 2018,13127,13127,2018,2016,11,6,5,0.260,0.066,0.638,200.154,19,20,82625,83975,4348,4198,60905,62505,3205,3125,150,80
2018 - 2020,13127,13127,2020,2018,10,5,5,0.252,0.066,0.637,202.581,20,20,83975,85010,4198,4250,62505,64270,3125,3213,52,88
2020 - 2022,13127,13127,2022,2020,12,6,6,0.246,0.068,0.637,201.520,20,20,85010,84565,4250,4228,64270,64630,3213,3231,22,18
2016 - 2018,13129,13129,2018,2016,4,2,2,0.039,0.156,0.779,159.598,12,12,56080,56790,4673,4732,38090,39040,3174,3253,59,79
2018 - 2020,13129,13129,2020,2018,4,2,2,0.038,0.161,0.772,162.032,12,12,56790,57755,4732,4812,39040,40410,3253,3367,80,114
2020 - 2022,13129,13129,2022,2020,3,2,1,0.033,0.168,0.762,162.116,12,13,57755,57785,4812,4445,40410,41045,3367,3157,367,210
2016 - 2018,13131,13131,2018,2016,4,4,0,0.282,0.111,0.582,54.840,9,13,25145,24925,2793,1917,17620,17430,1957,1340,876,617
2018 - 2020,13131,13131,2020,2018,0,0,0,0.288,0.114,0.580,54.339,13,13,24925,24695,1917,1899,17430,17380,1340,1336,18,4
2020 - 2022,13131,13131,2022,2020,4,2,2,0.291,0.119,0.575,57.376,13,13,24695,26075,1899,2005,17380,18470,1336,1420,106,84
2016 - 2018,13133,13133,2018,2016,7,5,2,0.353,0.060,0.571,43.789,4,7,16535,16975,4133,2425,12705,13245,3176,1892,1708,1284
2018 - 2020,13133,13133,2020,2018,7,2,5,0.344,0.061,0.582,45.959,7,4,16975,17810,2425,4452,13245,14000,1892,3500,2027,1608
2020 - 2022,13133,13133,2022,2020,0,0,0,0.315,0.066,0.594,49.082,4,4,17810,19020,4452,4755,14000,15175,3500,3793,303,293
2016 - 2018,13135,13135,2018,2016,23,12,11,0.267,0.209,0.385,2095.676,154,155,874240,902300,5676,5821,519180,539910,3371,3483,145,112
2018 - 2020,13135,13135,2020,2018,10,5,5,0.274,0.212,0.365,2150.670,155,155,902300,926415,5821,5976,539910,562370,3483,3628,155,145
2020 - 2022,13135,13135,2022,2020,61,31,30,0.281,0.218,0.342,2223.932,155,156,926415,957975,5976,6140,562370,591850,3628,3793,164,165
2016 - 2018,13137,13137,2018,2016,2,1,1,0.031,0.145,0.781,159.991,7,7,43725,44290,6246,6327,31370,31875,4481,4553,81,72
2018 - 2020,13137,13137,2020,2018,0,0,0,0.029,0.156,0.769,163.273,7,7,44290,45205,6327,6457,31875,32885,4553,4697,130,144
2020 - 2022,13137,13137,2022,2020,3,1,2,0.035,0.163,0.758,167.319,7,6,45205,46325,6457,7720,32885,32950,4697,5491,1263,794
2016 - 2018,13139,13139,2018,2016,6,3,3,0.072,0.281,0.612,498.646,31,31,190480,195960,6144,6321,117555,122400,3792,3948,177,156
2018 - 2020,13139,13139,2020,2018,2,1,1,0.070,0.285,0.607,512.573,31,31,195960,201435,6321,6497,122400,128785,3948,4154,176,206
2020 - 2022,13139,13139,2022,2020,16,8,8,0.068,0.293,0.596,521.522,31,31,201435,204955,6497,6611,128785,133065,4154,4292,114,138
2016 - 2018,13141,13141,2018,2016,0,0,0,0.723,0.019,0.243,18.118,10,10,8745,8535,874,853,7230,7190,723,719,21,4
2018 - 2020,13141,13141,2020,2018,0,0,0,0.721,0.015,0.244,18.044,10,10,8535,8500,853,850,7190,7430,719,743,3,24
2020 - 2022,13141,13141,2022,2020,1,1,0,0.717,0.007,0.254,18.235,10,11,8500,8590,850,780,7430,7365,743,669,70,74
2016 - 2018,13143,13143,2018,2016,6,3,3,0.047,0.016,0.913,102.617,11,11,28665,28955,2605,2632,21515,21830,1955,1984,27,29
2018 - 2020,13143,13143,2020,2018,6,3,3,0.043,0.019,0.909,104.939,11,11,28955,29610,2632,2691,21830,22420,1984,2038,59,54
2020 - 2022,13143,13143,2022,2020,2,1,1,0.047,0.022,0.904,106.959,11,11,29610,30180,2691,2743,22420,22835,2038,2075,52,37
2016 - 2018,13145,13145,2018,2016,8,4,4,0.161,0.034,0.770,72.416,10,10,32990,33590,3299,3359,25325,26005,2532,2600,60,68
2018 - 2020,13145,13145,2020,2018,2,1,1,0.161,0.038,0.766,74.763,10,10,33590,34675,3359,3467,26005,27015,2600,2701,108,101
2020 - 2022,13145,13145,2022,2020,7,4,3,0.157,0.044,0.759,75.278,10,11,34675,34915,3467,3174,27015,27245,2701,2476,293,225
2016 - 2018,13147,13147,2018,2016,0,0,0,0.184,0.037,0.751,110.274,7,7,25520,25630,3645,3661,19680,19885,2811,2840,16,29
2018 - 2020,13147,13147,2020,2018,0,0,0,0.196,0.037,0.747,111.779,7,7,25630,25980,3661,3711,19885,20415,2840,2916,50,76
2020 - 2022,13147,13147,2022,2020,5,3,2,0.177,0.039,0.747,112.339,7,8,25980,26110,3711,3263,20415,20335,2916,2541,448,375
2016 - 2018,13149,13149,2018,2016,2,1,1,0.093,0.027,0.849,39.442,6,6,11570,11675,1928,1945,8830,8810,1471,1468,17,3
2018 - 2020,13149,13149,2020,2018,2,1,1,0.085,0.028,0.849,39.818,6,6,11675,11785,1945,1964,8810,8970,1468,1495,19,27
2020 - 2022,13149,13149,2022,2020,3,2,1,0.085,0.032,0.843,38.821,6,7,11785,11490,1964,1641,8970,8750,1495,1250,323,245
2016 - 2018,13151,13151,2018,2016,51,26,25,0.419,0.067,0.453,694.511,37,38,214170,221305,5788,5823,150235,157255,4060,4138,35,78
2018 - 2020,13151,13151,2020,2018,17,8,9,0.451,0.071,0.416,721.649,38,37,221305,229995,5823,6216,157255,165400,4138,4470,393,332
2020 - 2022,13151,13151,2022,2020,46,24,22,0.481,0.076,0.375,755.739,37,39,229995,240855,6216,6175,165400,175205,4470,4492,41,22
2016 - 2018,13153,13153,2018,2016,1,1,0,0.302,0.066,0.571,403.343,14,15,149135,151680,10652,10112,107010,108840,7643,7256,540,387
2018 - 2020,13153,13153,2020,2018,1,0,1,0.309,0.066,0.557,413.021,15,14,151680,155315,10112,11093,108840,112230,7256,8016,981,760
2020 - 2022,13153,13153,2022,2020,10,5,5,0.314,0.068,0.542,436.422,14,14,155315,164115,11093,11722,112230,118735,8016,8481,629,465
2016 - 2018,13155,13155,2018,2016,4,4,0,0.295,0.015,0.674,26.160,2,6,9365,9270,4682,1545,7245,7230,3622,1205,3137,2417
2018 - 2020,13155,13155,2020,2018,5,1,4,0.285,0.041,0.666,26.470,6,3,9270,9380,1545,3126,7230,7335,1205,2445,1581,1240
2020 - 2022,13155,13155,2022,2020,2,1,1,0.262,0.042,0.681,26.766,3,3,9380,9485,3126,3161,7335,7355,2445,2451,35,6
2016 - 2018,13157,13157,2018,2016,17,14,3,0.066,0.074,0.821,193.587,4,15,62130,65755,15532,4383,44550,47125,11137,3141,11149,7996
2018 - 2020,13157,13157,2020,2018,17,3,14,0.070,0.081,0.811,207.458,15,4,65755,70465,4383,17616,47125,51115,3141,12778,13233,9637
2020 - 2022,13157,13157,2022,2020,3,2,1,0.072,0.092,0.794,226.857,4,5,70465,77035,17616,15407,51115,55915,12778,11183,2209,1595
2016 - 2018,13159,13159,2018,2016,0,0,0,0.209,0.039,0.739,37.418,3,3,13570,13785,4523,4595,10025,10320,3341,3440,72,99
2018 - 2020,13159,13159,2020,2018,0,0,0,0.197,0.039,0.746,38.205,3,3,13785,14075,4595,4691,10320,10565,3440,3521,96,81
2020 - 2022,13159,13159,2022,2020,1,1,0,0.187,0.041,0.754,40.390,3,4,14075,14880,4691,3720,10565,11195,3521,2798,971,723
2016 - 2018,13161,13161,2018,2016,13,8,5,0.163,0.117,0.717,45.298,6,9,14955,14990,2492,1665,10370,10570,1728,1174,827,554
2018 - 2020,13161,13161,2020,2018,11,3,8,0.162,0.123,0.710,45.525,9,4,14990,15065,1665,3766,10570,11000,1174,2750,2101,1576
2020 - 2022,13161,13161,2022,2020,3,3,0,0.156,0.132,0.698,44.694,4,7,15065,14790,3766,2112,11000,10565,2750,1509,1654,1241
2016 - 2018,13163,13163,2018,2016,4,2,2,0.538,0.036,0.419,29.950,8,8,16200,15770,2025,1971,11985,11770,1498,1471,54,27
2018 - 2020,13163,13163,2020,2018,2,1,1,0.528,0.039,0.422,29.418,8,8,15770,15490,1971,1936,11770,11630,1471,1453,35,18
2020 - 2022,13163,13163,2022,2020,5,3,2,0.522,0.040,0.423,29.608,8,9,15490,15590,1936,1732,11630,11600,1453,1288,204,165
2016 - 2018,13165,13165,2018,2016,2,2,0,0.333,0.084,0.560,25.408,3,5,9055,8825,3018,1765,6830,6535,2276,1307,1253,969
2018 - 2020,13165,13165,2020,2018,2,0,2,0.357,0.063,0.554,25.293,5,3,8825,8785,1765,2928,6535,6665,1307,2221,1163,914
2020 - 2022,13165,13165,2022,2020,1,1,0,0.350,0.075,0.566,25.059,3,4,8785,8705,2928,2176,6665,6930,2221,1732,752,489
2016 - 2018,13167,13167,2018,2016,2,1,1,0.335,0.024,0.625,32.110,4,4,9695,9730,2423,2432,7670,7795,1917,1948,9,31
2018 - 2020,13167,13167,2020,2018,2,1,1,0.339,0.026,0.620,32.061,4,4,9730,9715,2432,2428,7795,7855,1948,1963,4,15
2020 - 2022,13167,13167,2022,2020,1,1,0,0.329,0.029,0.613,30.444,4,5,9715,9225,2428,1845,7855,7485,1963,1497,583,466
2016 - 2018,13169,13169,2018,2016,0,0,0,0.245,0.016,0.716,72.473,10,10,28700,28550,2870,2855,21655,21680,2165,2168,15,3
2018 - 2020,13169,13169,2020,2018,0,0,0,0.244,0.018,0.710,72.650,10,10,28550,28620,2855,2862,21680,21855,2168,2185,7,17
2020 - 2022,13169,13169,2022,2020,0,0,0,0.246,0.020,0.705,72.041,10,10,28620,28380,2862,2838,21855,21720,2185,2172,24,13
2016 - 2018,13171,13171,2018,2016,4,2,2,0.291,0.024,0.650,100.899,6,6,18195,18515,3032,3085,14175,14465,2362,2410,53,48
2018 - 2020,13171,13171,2020,2018,0,0,0,0.285,0.025,0.651,102.643,6,6,18515,18835,3085,3139,14465,14790,2410,2465,54,55
2020 - 2022,13171,13171,2022,2020,5,3,2,0.270,0.029,0.660,101.771,6,7,18835,18675,3139,2667,14790,14690,2465,2098,472,367
2016 - 2018,13173,13173,2018,2016,5,4,1,0.242,0.055,0.687,52.738,1,4,10380,10365,10380,2591,7615,7685,7615,1921,7789,5694
2018 - 2020,13173,13173,2020,2018,3,0,3,0.231,0.064,0.681,53.603,4,1,10365,10535,2591,10535,7685,8040,1921,8040,7944,6119
2020 - 2022,13173,13173,2022,2020,3,2,1,0.232,0.073,0.669,50.703,1,2,10535,9965,10535,4982,8040,7425,8040,3712,5553,4328
2016 - 2018,13175,13175,2018,2016,3,2,1,0.371,0.026,0.585,58.739,16,17,47800,47420,2987,2789,35365,35500,2210,2088,198,122
2018 - 2020,13175,13175,2020,2018,3,1,2,0.375,0.027,0.578,58.718,17,16,47420,47405,2789,2962,35500,35345,2088,2209,173,121
2020 - 2022,13175,13175,2022,2020,5,3,2,0.375,0.029,0.574,61.195,16,17,47405,49405,2962,2906,35345,36955,2209,2173,56,36
2016 - 2018,13177,13177,2018,2016,0,0,0,0.202,0.029,0.724,82.471,10,10,29135,29350,2913,2935,20810,21255,2081,2125,22,44
2018 - 2020,13177,13177,2020,2018,0,0,0,0.217,0.030,0.710,83.553,10,10,29350,29735,2935,2973,21255,21720,2125,2172,38,47
2020 - 2022,13177,13177,2022,2020,5,3,2,0.235,0.033,0.693,92.653,10,11,29735,32970,2973,2997,21720,23970,2172,2179,24,7
2016 - 2018,13179,13179,2018,2016,4,2,2,0.402,0.126,0.397,120.259,13,13,63950,62110,4919,4777,44320,43185,3409,3321,142,88
2018 - 2020,13179,13179,2020,2018,0,0,0,0.403,0.127,0.384,120.123,13,13,62110,62040,4777,4772,43185,43055,3321,3311,5,10
2020 - 2022,13179,13179,2022,2020,11,6,5,0.407,0.127,0.380,126.921,13,14,62040,65550,4772,4682,43055,45630,3311,3259,90,52
2016 - 2018,13181,13181,2018,2016,0,0,0,0.315,0.017,0.658,37.076,7,7,7710,7800,1101,1114,6180,6240,882,891,13,9
2018 - 2020,13181,13181,2020,2018,0,0,0,0.300,0.020,0.665,37.693,7,7,7800,7930,1114,1132,6240,6250,891,892,18,1
2020 - 2022,13181,13181,2022,2020,0,0,0,0.282,0.022,0.676,36.719,7,7,7930,7725,1132,1103,6250,6095,892,870,29,22
2016 - 2018,13183,13183,2018,2016,5,2,3,0.235,0.113,0.584,45.343,6,5,17245,18155,2874,3631,11505,12155,1917,2431,757,514
2018 - 2020,13183,13183,2020,2018,5,3,2,0.249,0.114,0.574,48.041,5,6,18155,19235,3631,3205,12155,13465,2431,2244,426,187
2020 - 2022,13183,13183,2022,2020,1,1,0,0.230,0.117,0.562,41.971,6,7,19235,16805,3205,2400,13465,11850,2244,1692,805,552
2016 - 2018,13185,13185,2018,2016,8,2,6,0.363,0.055,0.543,230.472,13,9,113900,114580,8761,12731,83885,84650,6452,9405,3970,2953
2018 - 2020,13185,13185,2020,2018,2,1,1,0.369,0.058,0.534,234.163,9,9,114580,116435,12731,12937,84650,86455,9405,9606,206,201
2020 - 2022,13185,13185,2022,2020,18,14,4,0.368,0.062,0.526,237.823,9,19,116435,118255,12937,6223,86455,87675,9606,4614,6714,4992
2016 - 2018,13187,13187,2018,2016,1,0,1,0.018,0.048,0.907,112.921,2,1,31095,31950,15547,31950,24340,25525,12170,25525,16403,13355
2018 - 2020,13187,13187,2020,2018,0,0,0,0.021,0.049,0.905,116.666,1,1,31950,33010,31950,33010,25525,26510,25525,26510,1060,985
2020 - 2022,13187,13187,2022,2020,2,2,0,0.012,0.052,0.900,118.062,1,3,33010,33405,33010,11135,26510,27055,26510,9018,21875,17492
2016 - 2018,13189,13189,2018,2016,7,5,2,0.403,0.030,0.538,83.504,2,5,21560,21500,10780,4300,15710,15730,7855,3146,6480,4709
2018 - 2020,13189,13189,2020,2018,3,0,3,0.399,0.032,0.532,83.168,5,2,21500,21405,4300,10702,15730,15815,3146,7907,6402,4761
2020 - 2022,13189,13189,2022,2020,5,3,2,0.412,0.035,0.529,84.372,2,3,21405,21715,10702,7238,15815,16115,7907,5371,3464,2536
2016 - 2018,13191,13191,2018,2016,4,2,2,0.341,0.010,0.619,32.734,6,6,13940,14120,2323,2353,11305,11610,1884,1935,30,51
2018 - 2020,13191,13191,2020,2018,0,0,0,0.346,0.004,0.620,32.954,6,6,14120,14215,2353,2369,11610,11865,1935,1977,16,42
2020 - 2022,13191,13191,2022,2020,5,2,3,0.317,0.026,0.624,25.930,6,5,14215,11185,2369,2237,11865,9470,1977,1894,132,83
2016 - 2018,13193,13193,2018,2016,2,1,1,0.606,0.042,0.333,33.644,5,5,13845,13480,2769,2696,10845,10715,2169,2143,73,26
2018 - 2020,13193,13193,2020,2018,0,0,0,0.619,0.043,0.330,32.708,5,5,13480,13105,2696,2621,10715,10480,2143,2096,75,47
2020 - 2022,13193,13193,2022,2020,4,2,2,0.601,0.047,0.331,30.200,5,5,13105,12100,2621,2420,10480,9600,2096,1920,201,176
2016 - 2018,13195,13195,2018,2016,8,4,4,0.088,0.052,0.827,102.363,12,12,28360,28900,2363,2408,21180,21655,1765,1804,45,39
2018 - 2020,13195,13195,2020,2018,2,1,1,0.090,0.058,0.815,104.933,12,12,28900,29625,2408,2468,21655,22320,1804,1860,60,56
2020 - 2022,13195,13195,2022,2020,8,4,4,0.088,0.065,0.802,107.607,12,12,29625,30380,2468,2531,22320,22890,1860,1907,63,47
2016 - 2018,13197,13197,2018,2016,0,0,0,0.305,0.071,0.594,23.182,3,3,8645,8485,2881,2828,6580,6555,2193,2185,53,8
2018 - 2020,13197,13197,2020,2018,0,0,0,0.301,0.078,0.590,23.105,3,3,8485,8450,2828,2816,6555,6400,2185,2133,12,52
2020 - 2022,13197,13197,2022,2020,0,0,0,0.294,0.083,0.587,20.535,3,3,8450,7510,2816,2503,6400,5635,2133,1878,313,255
2016 - 2018,13199,13199,2018,2016,6,3,3,0.387,0.021,0.565,42.127,13,13,21195,21115,1630,1624,16385,16325,1260,1255,6,5
2018 - 2020,13199,13199,2020,2018,4,2,2,0.403,0.023,0.565,42.084,13,13,21115,21080,1624,1621,16325,16515,1255,1270,3,15
2020 - 2022,13199,13199,2022,2020,3,2,1,0.383,0.027,0.571,41.285,13,14,21080,20680,1621,1477,16515,16230,1270,1159,144,111
2016 - 2018,13201,13201,2018,2016,0,0,0,0.303,0.006,0.682,20.661,1,1,5910,5835,5910,5835,4540,4490,4540,4490,75,50
2018 - 2020,13201,13201,2020,2018,0,0,0,0.308,0.005,0.676,20.271,1,1,5835,5725,5835,5725,4490,4385,4490,4385,110,105
2020 - 2022,13201,13201,2022,2020,1,1,0,0.273,0.030,0.668,20.979,1,2,5725,5925,5725,2962,4385,4490,4385,2245,2763,2140
2016 - 2018,13205,13205,2018,2016,0,0,0,0.465,0.045,0.461,43.795,12,12,22780,22430,1898,1869,16900,16625,1408,1385,29,23
2018 - 2020,13205,13205,2020,2018,0,0,0,0.459,0.047,0.457,43.092,12,12,22430,22070,1869,1839,16625,16730,1385,1394,30,9
2020 - 2022,13205,13205,2022,2020,3,2,1,0.447,0.050,0.460,42.243,12,13,22070,21635,1839,1664,16730,16375,1394,1259,175,135
2016 - 2018,13207,13207,2018,2016,0,0,0,0.233,0.023,0.723,68.191,13,13,27045,27010,2080,2077,21050,20990,1619,1614,3,5
2018 - 2020,13207,13207,2020,2018,0,0,0,0.228,0.024,0.726,69.315,13,13,27010,27455,2077,2111,20990,21410,1614,1646,34,32
2020 - 2022,13207,13207,2022,2020,3,2,1,0.216,0.025,0.727,71.410,13,14,27455,28285,2111,2020,21410,22275,1646,1591,91,55
2016 - 2018,13209,13209,2018,2016,2,1,1,0.259,0.065,0.664,37.467,7,7,9005,9035,1286,1290,6715,6785,959,969,4,10
2018 - 2020,13209,13209,2020,2018,0,0,0,0.256,0.069,0.661,37.612,7,7,9035,9070,1290,1295,6785,7010,969,1001,5,32
2020 - 2022,13209,13209,2022,2020,3,2,1,0.235,0.074,0.655,36.016,7,8,9070,8685,1295,1085,7010,6745,1001,843,210,158
2016 - 2018,13211,13211,2018,2016,2,1,1,0.233,0.032,0.718,52.489,7,7,17945,18235,2563,2605,13630,13880,1947,1982,42,35
2018 - 2020,13211,13211,2020,2018,0,0,0,0.228,0.031,0.727,54.201,7,7,18235,18830,2605,2690,13880,14350,1982,2050,85,68
2020 - 2022,13211,13211,2022,2020,3,1,2,0.214,0.032,0.735,58.058,7,6,18830,20170,2690,3361,14350,15530,2050,2588,671,538
2016 - 2018,13213,13213,2018,2016,7,4,3,0.011,0.148,0.829,114.821,5,6,39360,39555,7872,6592,27310,27420,5462,4570,1280,892
2018 - 2020,13213,13213,2020,2018,7,3,4,0.009,0.152,0.824,115.503,6,5,39555,39790,6592,7958,27420,28000,4570,5600,1366,1030
2020 - 2022,13213,13213,2022,2020,3,2,1,0.004,0.159,0.813,116.301,5,6,39790,40065,7958,6677,28000,28655,5600,4775,1281,825
2016 - 2018,13215,13215,2018,2016,9,5,4,0.454,0.076,0.410,908.670,25,26,200305,196670,8012,7564,146005,143465,5840,5517,448,323
2018 - 2020,13215,13215,2020,2018,3,1,2,0.458,0.077,0.401,902.655,26,25,196670,195420,7564,7816,143465,143165,5517,5726,252,209
2020 - 2022,13215,13215,2022,2020,31,8,23,0.462,0.080,0.391,944.897,25,10,195420,204570,7816,20457,143165,149905,5726,14990,12641,9264
2016 - 2018,13217,13217,2018,2016,2,1,1,0.436,0.054,0.477,389.024,23,23,103900,106495,4517,4630,72890,75520,3169,3283,113,114
2018 - 2020,13217,13217,2020,2018,2,1,1,0.456,0.058,0.452,401.145,23,23,106495,109835,4630,4775,75520,78275,3283,3403,145,120
2020 - 2022,13217,13217,2022,2020,11,6,5,0.466,0.063,0.425,413.784,23,24,109835,113300,4775,4720,78275,81140,3403,3380,55,23
2016 - 2018,13219,13219,2018,2016,13,8,5,0.054,0.049,0.847,200.808,10,13,35070,37015,3507,2847,24415,26045,2441,2003,660,438
2018 - 2020,13219,13219,2020,2018,0,0,0,0.049,0.054,0.840,212.621,13,13,37015,39195,2847,3015,26045,27795,2003,2138,168,135
2020 - 2022,13219,13219,2022,2020,14,5,9,0.034,0.057,0.835,227.729,13,9,39195,41980,3015,4664,27795,29825,2138,3313,1649,1175
2016 - 2018,13221,13221,2018,2016,2,1,1,0.178,0.044,0.758,33.674,3,3,14745,14785,4915,4928,11195,11390,3731,3796,13,65
2018 - 2020,13221,13221,2020,2018,2,1,1,0.172,0.049,0.754,34.255,3,3,14785,15040,4928,5013,11390,11635,3796,3878,85,82
2020 - 2022,13221,13221,2022,2020,1,1,0,0.169,0.059,0.746,34.107,3,4,15040,14975,5013,3743,11635,11685,3878,2921,1270,957
2016 - 2018,13223,13223,2018,2016,25,10,15,0.183,0.061,0.721,499.021,20,15,149830,155840,7491,10389,104740,110450,5237,7363,2898,2126
2018 - 2020,13223,13223,2020,2018,8,3,5,0.195,0.067,0.696,526.460,15,13,155840,164440,10389,12649,110450,117500,7363,9038,2260,1675
2020 - 2022,13223,13223,2022,2020,23,14,9,0.208,0.076,0.665,543.940,13,18,164440,169900,12649,9438,117500,121295,9038,6738,3211,2300
2016 - 2018,13225,13225,2018,2016,0,0,0,0.446,0.075,0.459,179.448,6,6,26905,26965,4484,4494,20060,20400,3343,3400,10,57
2018 - 2020,13225,13225,2020,2018,0,0,0,0.443,0.077,0.455,182.986,6,6,26965,27500,4494,4583,20400,20945,3400,3490,89,90
2020 - 2022,13225,13225,2022,2020,1,1,0,0.437,0.082,0.449,186.680,6,7,27500,28055,4583,4007,20945,21680,3490,3097,576,393
2016 - 2018,13227,13227,2018,2016,2,1,1,0.013,0.031,0.873,132.855,12,12,29990,30830,2499,2569,23350,24155,1945,2012,70,67
2018 - 2020,13227,13227,2020,2018,0,0,0,0.016,0.031,0.859,137.896,12,12,30830,32000,2569,2666,24155,25210,2012,2100,97,88
2020 - 2022,13227,13227,2022,2020,5,3,2,0.005,0.033,0.931,144.101,12,13,32000,33440,2666,2572,25210,26595,2100,2045,94,55
2016 - 2018,13229,13229,2018,2016,0,0,0,0.095,0.050,0.841,56.293,2,2,19030,19165,9515,9582,13885,13960,6942,6980,67,38
2018 - 2020,13229,13229,2020,2018,0,0,0,0.101,0.050,0.841,56.791,2,2,19165,19335,9582,9667,13960,14210,6980,7105,85,125
2020 - 2022,13229,13229,2022,2020,1,1,0,0.097,0.051,0.837,58.216,2,3,19335,19820,9667,6606,14210,14650,7105,4883,3061,2222
2016 - 2018,13231,13231,2018,2016,6,3,3,0.100,0.015,0.869,83.670,8,8,17845,18080,2230,2260,13275,13610,1659,1701,30,42
2018 - 2020,13231,13231,2020,2018,0,0,0,0.093,0.017,0.870,85.915,8,8,18080,18565,2260,2320,13610,14145,1701,1768,60,67
2020 - 2022,13231,13231,2022,2020,7,4,3,0.089,0.019,0.870,88.599,8,9,18565,19145,2320,2127,14145,14540,1768,1615,193,153
2016 - 2018,13233,13233,2018,2016,4,2,2,0.122,0.131,0.721,134.115,7,7,41265,41620,5895,5945,28485,28990,4069,4141,50,72
2018 - 2020,13233,13233,2020,2018,4,2,2,0.113,0.132,0.719,136.143,7,7,41620,42250,5945,6035,28990,29530,4141,4218,90,77
2020 - 2022,13233,13233,2022,2020,3,2,1,0.126,0.138,0.711,138.622,7,8,42250,43020,6035,5377,29530,30070,4218,3758,658,460
2016 - 2018,13235,13235,2018,2016,0,0,0,0.347,0.041,0.595,45.314,2,2,11460,11295,5730,5647,9260,9295,4630,4647,83,17
2018 - 2020,13235,13235,2020,2018,0,0,0,0.382,0.029,0.577,44.873,2,2,11295,11185,5647,5592,9295,9140,4647,4570,55,77
2020 - 2022,13235,13235,2022,2020,2,1,1,0.363,0.042,0.563,39.657,2,2,11185,9885,5592,4942,9140,7870,4570,3935,650,635
2016 - 2018,13237,13237,2018,2016,2,1,1,0.262,0.064,0.655,62.391,5,5,21260,21505,4252,4301,16335,16640,3267,3328,49,61
2018 - 2020,13237,13237,2020,2018,0,0,0,0.263,0.063,0.657,63.551,5,5,21505,21905,4301,4381,16640,17125,3328,3425,80,97
2020 - 2022,13237,13237,2022,2020,2,1,1,0.256,0.064,0.658,64.422,5,5,21905,22205,4381,4441,17125,17440,3425,3488,60,63
2016 - 2018,13239,13239,2018,2016,2,1,1,0.523,0.002,0.385,15.043,2,2,2095,2275,1047,1137,1680,1775,840,887,90,47
2018 - 2020,13239,13239,2020,2018,0,0,0,0.469,0.013,0.421,15.142,2,2,2275,2290,1137,1145,1775,1910,887,955,8,68
2020 - 2022,13239,13239,2022,2020,3,2,1,0.525,0.039,0.422,14.414,2,3,2290,2180,1145,726,1910,1925,955,641,419,314
2016 - 2018,13241,13241,2018,2016,2,1,1,0.017,0.081,0.879,44.456,1,1,16310,16455,16310,16455,12795,13135,12795,13135,145,340
2018 - 2020,13241,13241,2020,2018,0,0,0,0.014,0.079,0.880,45.551,1,1,16455,16860,16455,16860,13135,13395,13135,13395,405,260
2020 - 2022,13241,13241,2022,2020,2,1,1,0.012,0.080,0.883,45.700,1,1,16860,16915,16860,16915,13395,13735,13395,13735,55,340
2016 - 2018,13243,13243,2018,2016,4,3,1,0.622,0.013,0.349,16.545,5,7,7225,7085,1445,1012,5430,5240,1086,748,433,338
2018 - 2020,13243,13243,2020,2018,2,1,1,0.633,0.034,0.320,16.089,7,7,7085,6890,1012,984,5240,5040,748,720,28,28
2020 - 2022,13243,13243,2022,2020,2,0,2,0.648,0.033,0.306,14.863,7,5,6890,6365,984,1273,5040,4760,720,952,289,232
2016 - 2018,13245,13245,2018,2016,11,7,4,0.559,0.048,0.352,621.198,41,44,201420,201465,4912,4578,150325,151470,3666,3442,334,224
2018 - 2020,13245,13245,2020,2018,5,1,4,0.561,0.051,0.342,623.358,44,41,201465,202180,4578,4931,151470,152900,3442,3729,353,287
2020 - 2022,13245,13245,2022,2020,22,12,10,0.559,0.053,0.331,635.614,41,43,202180,206155,4931,4794,152900,156275,3729,3634,137,95
2016 - 2018,13247,13247,2018,2016,19,11,8,0.523,0.102,0.332,685.681,14,17,87570,89010,6255,5235,61345,63300,4381,3723,1020,658
2018 - 2020,13247,13247,2020,2018,18,8,10,0.552,0.102,0.302,694.473,17,15,89010,90155,5235,6010,63300,64805,3723,4320,775,597
2020 - 2022,13247,13247,2022,2020,15,8,7,0.573,0.105,0.273,721.314,15,16,90155,93640,6010,5852,64805,67750,4320,4234,158,86
2016 - 2018,13249,13249,2018,2016,0,0,0,0.298,0.052,0.649,31.215,1,1,5090,5210,5090,5210,3655,3950,3655,3950,120,295
2018 - 2020,13249,13249,2020,2018,0,0,0,0.270,0.063,0.650,31.245,1,1,5210,5215,5210,5215,3950,3995,3950,3995,5,45
2020 - 2022,13249,13249,2022,2020,1,1,0,0.179,0.057,0.755,27.350,1,2,5215,4565,5215,2282,3995,3455,3995,1727,2933,2268
2016 - 2018,13251,13251,2018,2016,0,0,0,0.420,0.020,0.547,21.664,12,12,14115,13990,1176,1165,10850,10880,904,906,11,2
2018 - 2020,13251,13251,2020,2018,0,0,0,0.408,0.024,0.547,21.641,12,12,13990,13975,1165,1164,10880,11010,906,917,1,11
2020 - 2022,13251,13251,2022,2020,2,1,1,0.401,0.026,0.555,21.717,12,12,13975,14025,1164,1168,11010,11100,917,925,4,8
2016 - 2018,13253,13253,2018,2016,0,0,0,0.330,0.031,0.617,35.510,5,5,8695,8435,1739,1687,6695,6575,1339,1315,52,24
2018 - 2020,13253,13253,2020,2018,0,0,0,0.351,0.012,0.614,34.604,5,5,8435,8220,1687,1644,6575,6505,1315,1301,43,14
2020 - 2022,13253,13253,2022,2020,1,1,0,0.330,0.036,0.617,38.372,5,6,8220,9115,1644,1519,6505,7270,1301,1211,125,90
2016 - 2018,13255,13255,2018,2016,7,5,2,0.335,0.044,0.591,330.231,17,20,64005,64720,3765,3236,47255,48215,2779,2410,529,369
2018 - 2020,13255,13255,2020,2018,7,2,5,0.342,0.047,0.580,337.015,20,17,64720,66045,3236,3885,48215,49675,2410,2922,649,512
2020 - 2022,13255,13255,2022,2020,4,3,1,0.346,0.051,0.566,344.006,17,19,66045,67415,3885,3548,49675,50730,2922,2670,337,252
2016 - 2018,13257,13257,2018,2016,0,0,0,0.112,0.033,0.826,143.315,1,1,25585,25675,25585,25675,19490,19610,19490,19610,90,120
2018 - 2020,13257,13257,2020,2018,0,0,0,0.113,0.037,0.818,144.999,1,1,25675,25935,25675,25935,19610,19955,19610,19955,260,345
2020 - 2022,13257,13257,2022,2020,2,2,0,0.107,0.042,0.814,149.445,1,3,25935,26730,25935,8910,19955,20610,19955,6870,17025,13085
2016 - 2018,13259,13259,2018,2016,4,2,2,0.544,0.172,0.247,13.166,4,4,5790,6040,1447,1510,3280,3335,820,833,63,13
2018 - 2020,13259,13259,2020,2018,2,1,1,0.573,0.157,0.227,14.049,4,4,6040,6445,1510,1611,3335,3935,833,983,101,150
2020 - 2022,13259,13259,2022,2020,0,0,0,0.611,0.128,0.220,11.161,4,4,6445,5120,1611,1280,3935,3545,983,886,331,97
2016 - 2018,13261,13261,2018,2016,3,1,2,0.525,0.054,0.396,62.853,11,10,31070,30350,2824,3035,22895,22580,2081,2258,211,177
2018 - 2020,13261,13261,2020,2018,0,0,0,0.529,0.058,0.391,61.537,10,10,30350,29715,3035,2971,22580,22095,2258,2209,64,49
2020 - 2022,13261,13261,2022,2020,11,5,6,0.510,0.061,0.391,60.844,10,9,29715,29380,2971,3264,22095,22340,2209,2482,293,273
2016 - 2018,13263,13263,2018,2016,0,0,0,0.578,0.008,0.405,16.301,7,7,6375,6380,910,911,5160,5250,737,750,1,13
2018 - 2020,13263,13263,2020,2018,0,0,0,0.567,0.008,0.408,15.956,7,7,6380,6245,911,892,5250,5195,750,742,19,8
2020 - 2022,13263,13263,2022,2020,1,1,0,0.565,0.009,0.408,14.807,7,8,6245,5795,892,724,5195,4845,742,605,168,137
2016 - 2018,13265,13265,2018,2016,0,0,0,0.649,0.015,0.330,8.556,2,2,1905,1665,952,832,1590,1405,795,702,120,93
2018 - 2020,13265,13265,2020,2018,0,0,0,0.586,0.044,0.364,8.196,2,2,1665,1595,832,797,1405,1340,702,670,35,32
2020 - 2022,13265,13265,2022,2020,1,1,0,0.541,0.061,0.355,8.402,2,3,1595,1635,797,545,1340,1365,670,455,252,215
2016 - 2018,13267,13267,2018,2016,4,2,2,0.292,0.110,0.586,52.733,7,7,25260,25355,3608,3622,19180,19270,2740,2752,14,12
2018 - 2020,13267,13267,2020,2018,2,1,1,0.290,0.119,0.578,52.803,7,7,25355,25390,3622,3627,19270,18990,2752,2712,5,40
2020 - 2022,13267,13267,2022,2020,4,2,2,0.281,0.125,0.572,50.557,7,7,25390,24310,3627,3472,18990,18305,2712,2615,155,97
2016 - 2018,13269,13269,2018,2016,2,1,1,0.384,0.026,0.572,21.756,4,4,8355,8195,2088,2048,6525,6460,1631,1615,40,16
2018 - 2020,13269,13269,2020,2018,0,0,0,0.380,0.007,0.575,21.570,4,4,8195,8125,2048,2031,6460,6355,1615,1588,17,27
2020 - 2022,13269,13269,2022,2020,3,2,1,0.385,0.007,0.580,20.707,4,5,8125,7800,2031,1560,6355,6160,1588,1232,471,356
2016 - 2018,13271,13271,2018,2016,9,5,4,0.384,0.118,0.492,36.851,6,7,16405,16115,2734,2302,11525,11370,1920,1624,432,296
2018 - 2020,13271,13271,2020,2018,6,3,3,0.390,0.114,0.491,36.290,7,7,16115,15870,2302,2267,11370,11680,1624,1668,35,44
2020 - 2022,13271,13271,2022,2020,4,2,2,0.351,0.174,0.467,28.858,7,7,15870,12620,2267,1802,11680,8785,1668,1255,465,413
2016 - 2018,13273,13273,2018,2016,0,0,0,0.586,0.027,0.356,26.390,6,6,9130,8860,1521,1476,6860,6630,1143,1105,45,38
2018 - 2020,13273,13273,2020,2018,0,0,0,0.578,0.029,0.357,25.775,6,6,8860,8655,1476,1442,6630,6415,1105,1069,34,36
2020 - 2022,13273,13273,2022,2020,0,0,0,0.584,0.030,0.360,26.817,6,6,8655,9005,1442,1500,6415,6835,1069,1139,58,70
2016 - 2018,13275,13275,2018,2016,9,6,3,0.364,0.037,0.576,82.132,17,20,44975,44730,2645,2236,33310,33320,1959,1666,409,293
2018 - 2020,13275,13275,2020,2018,0,0,0,0.368,0.037,0.576,81.789,20,20,44730,44545,2236,2227,33320,33305,1666,1665,9,1
2020 - 2022,13275,13275,2022,2020,11,5,6,0.359,0.039,0.576,83.845,20,19,44545,45665,2227,2403,33305,34255,1665,1802,176,137
2016 - 2018,13277,13277,2018,2016,2,1,1,0.301,0.115,0.562,155.269,12,12,40690,40510,3390,3375,29020,29060,2418,2421,15,3
2018 - 2020,13277,13277,2020,2018,0,0,0,0.294,0.120,0.553,155.583,12,12,40510,40590,3375,3382,29060,29030,2421,2419,7,2
2020 - 2022,13277,13277,2022,2020,2,1,1,0.290,0.126,0.544,158.093,12,12,40590,41245,3382,3437,29030,29430,2419,2452,55,33
2016 - 2018,13279,13279,2018,2016,2,1,1,0.259,0.116,0.605,74.312,6,6,27160,27050,4526,4508,18395,18645,3065,3107,18,42
2018 - 2020,13279,13279,2020,2018,0,0,0,0.258,0.116,0.602,74.022,6,6,27050,26945,4508,4490,18645,18840,3107,3140,18,33
2020 - 2022,13279,13279,2022,2020,3,2,1,0.238,0.121,0.595,74.022,6,7,26945,26945,4490,3849,18840,18740,3140,2677,641,463
2016 - 2018,13281,13281,2018,2016,3,2,1,0.012,0.012,0.947,68.573,3,4,10975,11415,3658,2853,9380,9840,3126,2460,805,666
2018 - 2020,13281,13281,2020,2018,0,0,0,0.013,0.029,0.939,70.971,4,4,11415,11815,2853,2953,9840,10265,2460,2566,100,106
2020 - 2022,13281,13281,2022,2020,2,0,2,0.013,0.029,0.939,75.355,4,2,11815,12545,2953,6272,10265,10860,2566,5430,3319,2864
2016 - 2018,13283,13283,2018,2016,2,1,1,0.271,0.018,0.709,33.971,2,2,6710,6775,3355,3387,5180,5035,2590,2517,32,73
2018 - 2020,13283,13283,2020,2018,0,0,0,0.290,0.018,0.690,34.022,2,2,6775,6785,3387,3392,5035,5045,2517,2522,5,5
2020 - 2022,13283,13283,2022,2020,2,1,1,0.285,0.009,0.686,32.141,2,2,6785,6410,3392,3205,5045,4855,2522,2427,187,95
2016 - 2018,13285,13285,2018,2016,5,3,2,0.356,0.037,0.568,168.536,14,15,69315,69775,4951,4651,49985,50790,3570,3386,300,184
2018 - 2020,13285,13285,2020,2018,2,1,1,0.366,0.037,0.561,169.308,15,15,69775,70095,4651,4673,50790,51450,3386,3430,22,44
2020 - 2022,13285,13285,2022,2020,4,2,2,0.362,0.039,0.555,167.931,15,15,70095,69525,4673,4635,51450,51210,3430,3414,38,16
2016 - 2018,13287,13287,2018,2016,0,0,0,0.430,0.016,0.541,27.889,3,3,8150,7960,2716,2653,5870,6000,1956,2000,63,44
2018 - 2020,13287,13287,2020,2018,0,0,0,0.395,0.049,0.533,27.749,3,3,7960,7920,2653,2640,6000,5865,2000,1955,13,45
2020 - 2022,13287,13287,2022,2020,0,0,0,0.384,0.051,0.541,31.165,3,3,7920,8895,2640,2965,5865,6440,1955,2146,325,191
2016 - 2018,13289,13289,2018,2016,0,0,0,0.424,0.005,0.551,23.061,5,5,8365,8285,1673,1657,6680,6620,1336,1324,16,12
2018 - 2020,13289,13289,2020,2018,0,0,0,0.420,0.016,0.549,22.811,5,5,8285,8195,1657,1639,6620,6520,1324,1304,18,20
2020 - 2022,13289,13289,2022,2020,3,2,1,0.417,0.010,0.551,22.143,5,6,8195,7955,1639,1325,6520,6390,1304,1065,314,239
2016 - 2018,13291,13291,2018,2016,0,0,0,0.007,0.032,0.939,70.711,11,11,22035,22775,2003,2070,18140,18685,1649,1698,67,49
2018 - 2020,13291,13291,2020,2018,0,0,0,0.008,0.035,0.938,74.514,11,11,22775,24000,2070,2181,18685,19905,1698,1809,111,111
2020 - 2022,13291,13291,2022,2020,1,1,0,0.006,0.038,0.932,77.247,11,12,24000,24880,2181,2073,19905,20720,1809,1726,108,83
2016 - 2018,13293,13293,2018,2016,0,0,0,0.278,0.023,0.674,81.044,4,4,26395,26215,6598,6553,20030,19930,5007,4982,45,25
2018 - 2020,13293,13293,2020,2018,0,0,0,0.275,0.024,0.672,81.399,4,4,26215,26330,6553,6582,19930,20000,4982,5000,29,18
2020 - 2022,13293,13293,2022,2020,0,0,0,0.271,0.024,0.671,85.449,4,4,26330,27640,6582,6910,20000,20995,5000,5248,328,248
2016 - 2018,13295,13295,2018,2016,6,3,3,0.041,0.021,0.912,154.181,11,11,68145,68825,6195,6256,52215,53075,4746,4825,61,79
2018 - 2020,13295,13295,2020,2018,4,2,2,0.038,0.024,0.907,155.469,11,11,68825,69400,6256,6309,53075,53930,4825,4902,53,77
2020 - 2022,13295,13295,2022,2020,3,2,1,0.039,0.027,0.902,152.514,11,12,69400,68065,6309,5672,53930,53140,4902,4428,637,474
2016 - 2018,13297,13297,2018,2016,12,6,6,0.176,0.042,0.755,275.804,21,21,87435,90130,4163,4291,63720,65900,3034,3138,128,104
2018 - 2020,13297,13297,2020,2018,2,1,1,0.184,0.047,0.739,285.432,21,21,90130,93285,4291,4442,65900,68560,3138,3264,151,126
2020 - 2022,13297,13297,2022,2020,13,7,6,0.193,0.054,0.719,299.094,21,22,93285,97750,4442,4443,68560,72405,3264,3291,1,27
2016 - 2018,13299,13299,2018,2016,7,4,3,0.296,0.041,0.636,39.592,11,12,35670,35600,3242,2966,26515,26380,2410,2198,276,212
2018 - 2020,13299,13299,2020,2018,2,1,1,0.305,0.041,0.628,39.750,12,12,35600,35745,2966,2978,26380,26870,2198,2239,12,41
2020 - 2022,13299,13299,2022,2020,6,3,3,0.299,0.046,0.625,39.939,12,12,35745,35915,2978,2992,26870,26550,2239,2212,14,27
2016 - 2018,13301,13301,2018,2016,0,0,0,0.613,0.005,0.373,18.797,1,1,5505,5345,5505,5345,4260,4165,4260,4165,160,95
2018 - 2020,13301,13301,2020,2018,0,0,0,0.608,0.000,0.378,18.498,1,1,5345,5260,5345,5260,4165,4140,4165,4140,85,25
2020 - 2022,13301,13301,2022,2020,0,0,0,0.598,0.000,0.385,18.269,1,1,5260,5195,5260,5195,4140,4135,4140,4135,65,5
2016 - 2018,13303,13303,2018,2016,2,1,1,0.528,0.024,0.429,30.154,8,8,20680,20460,2585,2557,15800,15680,1975,1960,28,15
2018 - 2020,13303,13303,2020,2018,0,0,0,0.528,0.026,0.424,29.940,8,8,20460,20315,2557,2539,15680,15720,1960,1965,18,5
2020 - 2022,13303,13303,2022,2020,3,2,1,0.508,0.028,0.422,29.439,8,9,20315,19975,2539,2219,15720,15555,1965,1728,320,237
2016 - 2018,13305,13305,2018,2016,7,6,1,0.196,0.062,0.716,46.367,7,12,30005,29765,4286,2480,21970,21805,3138,1817,1806,1321
2018 - 2020,13305,13305,2020,2018,7,1,6,0.203,0.064,0.712,46.680,12,7,29765,29960,2480,4280,21805,22170,1817,3167,1800,1350
2020 - 2022,13305,13305,2022,2020,4,2,2,0.199,0.065,0.710,47.171,7,7,29960,30275,4280,4325,22170,22425,3167,3203,45,36
2016 - 2018,13307,13307,2018,2016,2,1,1,0.400,0.096,0.495,12.491,1,1,2670,2615,2670,2615,2030,1975,2030,1975,55,55
2018 - 2020,13307,13307,2020,2018,0,0,0,0.329,0.124,0.530,12.330,1,1,2615,2585,2615,2585,1975,2005,1975,2005,30,30
2020 - 2022,13307,13307,2022,2020,2,1,1,0.446,0.146,0.384,11.233,1,1,2585,2355,2585,2355,2005,1860,2005,1860,230,145
2016 - 2018,13309,13309,2018,2016,0,0,0,0.421,0.013,0.560,26.871,2,2,7930,7940,3965,3970,6490,6535,3245,3267,5,22
2018 - 2020,13309,13309,2020,2018,0,0,0,0.390,0.050,0.559,26.718,2,2,7940,7895,3970,3947,6535,6520,3267,3260,23,7
2020 - 2022,13309,13309,2022,2020,1,1,0,0.383,0.057,0.555,25.551,2,3,7895,7550,3947,2516,6520,6325,3260,2108,1431,1152
2016 - 2018,13311,13311,2018,2016,1,1,0,0.025,0.031,0.924,120.169,10,11,28140,28930,2814,2630,21865,22705,2186,2064,184,122
2018 - 2020,13311,13311,2020,2018,0,0,0,0.025,0.033,0.923,124.447,11,11,28930,29960,2630,2723,22705,24255,2064,2205,93,141
2020 - 2022,13311,13311,2022,2020,5,2,3,0.021,0.034,0.919,116.991,11,10,29960,28165,2723,2816,24255,22610,2205,2261,93,56
2016 - 2018,13313,13313,2018,2016,16,8,8,0.039,0.345,0.591,357.564,23,23,103655,103850,4506,4515,62200,62790,2704,2730,9,26
2018 - 2020,13313,13313,2020,2018,2,1,1,0.034,0.355,0.581,358.485,23,23,103850,104120,4515,4526,62790,64765,2730,2815,11,85
2020 - 2022,13313,13313,2022,2020,25,13,12,0.032,0.368,0.567,354.749,23,24,104120,103035,4526,4293,64765,66125,2815,2755,233,60
2016 - 2018,13315,13315,2018,2016,3,2,1,0.354,0.045,0.590,23.411,4,5,8885,8845,2221,1769,7035,6965,1758,1393,452,365
2018 - 2020,13315,13315,2020,2018,3,1,2,0.357,0.048,0.589,23.027,5,4,8845,8700,1769,2175,6965,6815,1393,1703,406,310
2020 - 2022,13315,13315,2022,2020,1,1,0,0.337,0.047,0.596,23.398,4,5,8700,8840,2175,1768,6815,6910,1703,1382,407,321
2016 - 2018,13317,13317,2018,2016,0,0,0,0.425,0.048,0.511,21.054,7,7,9925,9885,1417,1412,7580,7580,1082,1082,5,0
2018 - 2020,13317,13317,2020,2018,0,0,0,0.419,0.052,0.513,20.863,7,7,9885,9795,1412,1399,7580,7515,1082,1073,13,9
2020 - 2022,13317,13317,2022,2020,0,0,0,0.403,0.057,0.516,20.469,7,7,9795,9610,1399,1372,7515,7415,1073,1059,27,14
2016 - 2018,13319,13319,2018,2016,0,0,0,0.393,0.028,0.567,20.213,9,9,9310,9080,1034,1008,7100,6860,788,762,26,26
2018 - 2020,13319,13319,2020,2018,0,0,0,0.390,0.029,0.567,19.913,9,9,9080,8945,1008,993,6860,6735,762,748,15,14
2020 - 2022,13319,13319,2022,2020,0,0,0,0.382,0.032,0.569,19.701,9,9,8945,8850,993,983,6735,6695,748,743,10,5
2016 - 2018,13321,13321,2018,2016,3,2,1,0.282,0.021,0.678,36.192,11,12,20990,20655,1908,1721,15965,15725,1451,1310,187,141
2018 - 2020,13321,13321,2020,2018,0,0,0,0.281,0.022,0.675,35.648,12,12,20655,20345,1721,1695,15725,15690,1310,1307,26,3
2020 - 2022,13321,13321,2022,2020,5,2,3,0.256,0.025,0.672,36.281,12,11,20345,20705,1695,1882,15690,15940,1307,1449,187,142
2012 - 2014,28001,28001,2014,2012,1,0,1,0.565,0.045,0.381,69.623,21,20,32390,32190,1542,1609,24335,23835,1158,1191,67,33
2014 - 2016,28001,28001,2016,2014,6,3,3,0.533,0.080,0.375,68.661,20,20,32190,31745,1609,1587,23835,22795,1191,1139,22,52
2016 - 2018,28001,28001,2018,2016,5,2,3,0.565,0.056,0.362,68.228,20,19,31745,31545,1587,1660,22795,22955,1139,1208,73,69
2018 - 2022,28001,28001,2022,2020,3,2,1,0.540,0.070,0.369,63.643,0,20,31105,29425,,1471,22555,21670,,1083,,
2012 - 2014,28003,28003,2014,2012,2,1,1,0.113,0.029,0.837,93.191,14,14,37025,37280,2644,2662,27730,27830,1980,1987,18,7
2014 - 2016,28003,28003,2016,2014,2,1,1,0.115,0.031,0.833,93.266,14,14,37280,37310,2662,2665,27830,27890,1987,1992,3,5
2016 - 2018,28003,28003,2018,2016,0,0,0,0.116,0.032,0.829,92.940,14,14,37310,37180,2665,2655,27890,28030,1992,2002,10,10
2018 - 2022,28003,28003,2022,2020,8,5,3,0.094,0.035,0.822,86.778,0,16,37060,34715,,2169,28305,26640,,1665,,
2012 - 2014,28005,28005,2014,2012,3,2,1,0.423,0.003,0.572,17.744,18,19,13140,12955,730,681,10135,10125,563,532,49,31
2014 - 2016,28005,28005,2016,2014,4,2,2,0.420,0.003,0.574,17.381,19,19,12955,12690,681,667,10125,9945,532,523,14,9
2016 - 2018,28005,28005,2018,2016,0,0,0,0.420,0.000,0.574,17.080,19,19,12690,12470,667,656,9945,9835,523,517,11,6
2018 - 2022,28005,28005,2022,2020,1,0,1,0.402,0.001,0.581,17.374,0,18,12340,12685,,704,9765,10060,,558,,
2012 - 2014,28007,28007,2014,2012,3,2,1,0.418,0.018,0.552,26.266,14,15,19455,19305,1389,1287,14230,14240,1016,949,102,67
2014 - 2016,28007,28007,2016,2014,2,1,1,0.419,0.019,0.547,25.967,15,15,19305,19085,1287,1272,14240,14140,949,942,15,7
2016 - 2018,28007,28007,2018,2016,2,1,1,0.426,0.021,0.538,25.280,15,15,19085,18580,1272,1238,14140,13745,942,916,34,26
2018 - 2022,28007,28007,2022,2020,12,6,6,0.422,0.022,0.527,24.274,0,15,18310,17840,,1189,13625,13330,,888,,
2012 - 2014,28009,28009,2014,2012,0,0,0,0.366,0.020,0.601,21.089,5,5,8725,8575,1745,1715,6510,6480,1302,1296,30,6
2014 - 2016,28009,28009,2016,2014,0,0,0,0.370,0.023,0.601,20.609,5,5,8575,8380,1715,1676,6480,6400,1296,1280,39,16
2016 - 2018,28009,28009,2018,2016,1,0,1,0.356,0.026,0.604,20.302,5,4,8380,8255,1676,2063,6400,6385,1280,1596,387,316
2018 - 2022,28009,28009,2022,2020,3,1,2,0.329,0.031,0.602,18.777,0,3,8275,7635,,2545,6215,5715,,1905,,
2012 - 2014,28011,28011,2014,2012,4,2,2,0.642,0.020,0.326,38.742,26,26,34240,33960,1316,1306,25390,25160,976,967,10,9
2014 - 2016,28011,28011,2016,2014,4,2,2,0.643,0.021,0.323,38.348,26,26,33960,33615,1306,1292,25160,24930,967,958,14,9
2016 - 2018,28011,28011,2018,2016,8,4,4,0.640,0.021,0.325,37.175,26,26,33615,32590,1292,1253,24930,24135,958,928,39,30
2018 - 2022,28011,28011,2022,2020,37,19,18,0.632,0.023,0.324,35.014,0,27,31255,30690,,1136,23160,22835,,845,,
2012 - 2014,28013,28013,2014,2012,1,1,0,0.273,0.055,0.656,25.299,8,9,14905,14840,1863,1648,10840,10850,1355,1205,215,150
2014 - 2016,28013,28013,2016,2014,2,0,2,0.272,0.055,0.654,25.103,9,7,14840,14725,1648,2103,10850,10850,1205,1550,455,345
2016 - 2018,28013,28013,2018,2016,3,2,1,0.272,0.059,0.649,24.839,7,8,14725,14570,2103,1821,10850,10805,1550,1350,282,200
2018 - 2022,28013,28013,2022,2020,3,0,3,0.284,0.065,0.642,22.495,0,5,14415,13195,,2639,10690,9845,,1969,,
2012 - 2014,28015,28015,2014,2012,3,1,2,0.337,0.004,0.647,16.586,11,10,10555,10420,959,1042,8295,8250,754,825,83,71
2014 - 2016,28015,28015,2016,2014,1,1,0,0.334,0.005,0.646,16.395,10,11,10420,10300,1042,936,8250,8200,825,745,106,80
2016 - 2018,28015,28015,2018,2016,0,0,0,0.346,0.003,0.643,16.123,11,11,10300,10130,936,920,8200,8150,745,740,16,5
2018 - 2022,28015,28015,2022,2020,4,2,2,0.358,0.001,0.632,15.802,0,11,9970,9930,,902,8085,8160,,741,,
2012 - 2014,28017,28017,2014,2012,0,0,0,0.433,0.038,0.523,34.627,8,8,17460,17375,2182,2171,12805,12670,1600,1583,11,17
2014 - 2016,28017,28017,2016,2014,0,0,0,0.434,0.042,0.511,34.587,8,8,17375,17355,2171,2169,12670,12665,1583,1583,2,0
2016 - 2018,28017,28017,2018,2016,1,0,1,0.435,0.047,0.501,34.437,8,7,17355,17280,2169,2468,12665,12740,1583,1820,299,237
2018 - 2022,28017,28017,2022,2020,8,6,2,0.437,0.051,0.491,33.929,0,11,17060,17025,,1547,12600,12430,,1130,,
2012 - 2014,28019,28019,2014,2012,1,1,0,0.314,0.004,0.677,20.087,14,15,8505,8400,607,560,6455,6425,461,428,47,33
2014 - 2016,28019,28019,2016,2014,3,1,2,0.314,0.002,0.675,19.896,15,14,8400,8320,560,594,6425,6395,428,456,34,28
2016 - 2018,28019,28019,2018,2016,5,3,2,0.312,0.004,0.675,19.895,14,15,8320,8320,594,554,6395,6460,456,430,40,26
2018 - 2022,28019,28019,2022,2020,10,4,6,0.292,0.018,0.672,19.632,0,13,8205,8210,,631,6420,6470,,497,,
2014 - 2016,28021,28021,2016,2014,4,4,0,0.849,0.013,0.126,18.896,0,4,9395,9210,,2302,7220,7150,,1787,,
2016 - 2018,28021,28021,2018,2016,1,1,0,0.874,0.002,0.117,18.711,4,5,9210,9120,2302,1824,7150,7075,1787,1415,478,372
2018 - 2022,28021,28021,2022,2020,4,2,2,0.857,0.002,0.112,18.557,0,5,9040,9045,,1809,7020,7070,,1414,,
2012 - 2014,28023,28023,2014,2012,3,2,1,0.356,0.006,0.636,23.873,21,22,16690,16510,794,750,12505,12520,595,569,44,26
2014 - 2016,28023,28023,2016,2014,4,2,2,0.347,0.010,0.637,23.432,22,22,16510,16205,750,736,12520,12385,569,562,14,7
2016 - 2018,28023,28023,2018,2016,1,0,1,0.358,0.004,0.634,23.034,22,21,16205,15930,736,758,12385,12325,562,586,22,24
2018 - 2022,28023,28023,2022,2020,7,4,3,0.343,0.016,0.628,22.492,0,22,15610,15555,,707,12125,12055,,547,,
2012 - 2014,28025,28025,2014,2012,2,1,1,0.581,0.012,0.397,49.785,13,13,20635,20415,1587,1570,15370,15230,1182,1171,17,11
2014 - 2016,28025,28025,2016,2014,0,0,0,0.582,0.013,0.393,49.126,13,13,20415,20145,1570,1549,15230,15150,1171,1165,21,6
2016 - 2018,28025,28025,2018,2016,27,14,13,0.595,0.007,0.390,48.309,13,14,20145,19810,1549,1415,15150,15145,1165,1081,134,84
2018 - 2022,28025,28025,2022,2020,2,1,1,0.601,0.002,0.380,45.358,0,14,19515,18600,,1328,14985,14370,,1026,,
2012 - 2014,28027,28027,2014,2012,0,0,0,0.758,0.003,0.227,46.204,1,1,26100,25525,26100,25525,18400,18165,18400,18165,575,235
2014 - 2016,28027,28027,2016,2014,17,17,0,0.771,0.002,0.220,44.894,1,18,25525,24805,25525,1378,18165,17845,18165,991,24147,17174
2016 - 2018,28027,28027,2018,2016,18,0,18,0.774,0.002,0.212,43.078,18,0,24805,23800,1378,,17845,17205,991,,,
2018 - 2022,28027,28027,2022,2020,17,17,0,0.760,0.018,0.198,38.447,0,17,22685,21265,,1250,16500,15310,,900,,
2012 - 2014,28029,28029,2014,2012,2,1,1,0.509,0.028,0.454,37.350,19,19,29325,29030,1543,1527,21855,21810,1150,1147,16,3
2014 - 2016,28029,28029,2016,2014,6,3,3,0.513,0.029,0.448,37.028,19,19,29030,28780,1527,1514,21810,21615,1147,1137,13,10
2016 - 2018,28029,28029,2018,2016,6,4,2,0.519,0.032,0.441,36.949,19,21,28780,28720,1514,1367,21615,21700,1137,1033,147,104
2018 - 2022,28029,28029,2022,2020,5,2,3,0.513,0.037,0.439,36.293,0,20,28340,28210,,1410,21615,21730,,1086,,
2012 - 2014,28031,28031,2014,2012,2,1,1,0.352,0.021,0.617,47.113,17,17,19570,19495,1151,1146,14420,14480,848,851,5,3
2014 - 2016,28031,28031,2016,2014,2,1,1,0.371,0.007,0.612,47.137,17,17,19495,19505,1146,1147,14480,14600,851,858,1,7
2016 - 2018,28031,28031,2018,2016,5,2,3,0.378,0.005,0.606,46.131,17,16,19505,19090,1147,1193,14600,14260,858,891,46,33
2018 - 2022,28031,28031,2022,2020,5,2,3,0.350,0.025,0.600,44.283,0,15,18810,18325,,1221,14135,13780,,918,,
2012 - 2014,28033,28033,2014,2012,8,4,4,0.230,0.050,0.690,349.091,35,35,161535,166265,4615,4750,113035,117520,3229,3357,135,128
2014 - 2016,28033,28033,2016,2014,12,7,5,0.247,0.047,0.676,358.802,35,37,166265,170890,4750,4618,117520,122190,3357,3302,132,55
2016 - 2018,28033,28033,2018,2016,6,3,3,0.261,0.049,0.656,369.773,37,37,170890,176130,4618,4760,122190,126625,3302,3422,142,120
2018 - 2022,28033,28033,2022,2020,34,18,16,0.309,0.052,0.602,390.924,0,39,182255,186215,,4774,131955,135925,,3485,,
2012 - 2014,28035,28035,2014,2012,4,3,1,0.364,0.034,0.579,163.420,32,34,75380,76160,2355,2240,55855,56655,1745,1666,115,79
2014 - 2016,28035,28035,2016,2014,28,0,28,0.368,0.031,0.574,163.666,34,6,76160,76275,2240,12712,56655,57035,1666,9505,10472,7839
2016 - 2018,28035,28035,2018,2016,30,28,2,0.369,0.030,0.570,162.035,6,32,76275,75515,12712,2359,57035,56700,9505,1771,10353,7734
2018 - 2022,28035,28035,2022,2020,47,24,23,0.361,0.032,0.571,167.185,0,33,75160,77915,,2361,56540,59115,,1791,,
2012 - 2014,28037,28037,2014,2012,11,11,0,0.356,0.001,0.636,14.092,0,11,8055,7945,,722,6025,5965,,542,,
2014 - 2016,28037,28037,2016,2014,0,0,0,0.357,0.010,0.632,13.872,11,11,7945,7820,722,710,5965,5890,542,535,12,7
2016 - 2018,28037,28037,2018,2016,1,0,1,0.360,0.006,0.632,13.751,11,10,7820,7755,710,775,5890,5880,535,588,65,53
2018 - 2022,28037,28037,2022,2020,1,1,0,0.358,0.001,0.628,13.636,0,11,7715,7690,,699,5905,5915,,537,,
2012 - 2014,28039,28039,2014,2012,8,3,5,0.079,0.021,0.882,47.964,22,20,22580,22960,1026,1148,16280,16630,740,831,122,91
2014 - 2016,28039,28039,2016,2014,3,1,2,0.070,0.023,0.879,48.705,20,19,22960,23315,1148,1227,16630,17045,831,897,79,66
2016 - 2018,28039,28039,2018,2016,3,2,1,0.081,0.027,0.874,49.530,19,20,23315,23710,1227,1185,17045,17160,897,858,42,39
2018 - 2022,28039,28039,2022,2020,3,2,1,0.078,0.032,0.869,51.275,0,21,24100,24545,,1168,17430,17795,,847,,
2012 - 2014,28041,28041,2014,2012,2,2,0,0.256,0.010,0.712,20.077,12,14,14350,14310,1195,1022,11225,11300,935,807,173,128
2014 - 2016,28041,28041,2016,2014,4,2,2,0.255,0.010,0.718,19.558,14,14,14310,13940,1022,995,11300,11030,807,787,27,20
2016 - 2018,28041,28041,2018,2016,6,3,3,0.255,0.012,0.722,19.243,14,14,13940,13715,995,979,11030,10825,787,773,16,14
2018 - 2022,28041,28041,2022,2020,2,1,1,0.255,0.013,0.713,19.180,0,14,13620,13670,,976,10820,11030,,787,,
2012 - 2014,28043,28043,2014,2012,2,0,2,0.429,0.002,0.558,51.314,14,12,21885,21660,1563,1805,16465,16415,1176,1367,242,191
2014 - 2016,28043,28043,2016,2014,2,1,1,0.437,0.001,0.553,50.982,12,12,21660,21520,1805,1793,16415,16370,1367,1364,12,3
2016 - 2018,28043,28043,2018,2016,1,0,1,0.433,0.007,0.549,50.412,12,11,21520,21280,1793,1934,16370,16145,1364,1467,141,103
2018 - 2022,28043,28043,2022,2020,1,1,0,0.449,0.004,0.538,50.874,0,12,20925,21475,,1789,15795,16120,,1343,,
2012 - 2014,28045,28045,2014,2012,13,5,8,0.086,0.034,0.856,95.233,26,23,44045,45135,1694,1962,32755,34235,1259,1488,268,229
2014 - 2016,28045,28045,2016,2014,11,6,5,0.095,0.037,0.852,97.117,23,24,45135,46030,1962,1917,34235,35305,1488,1471,45,17
2016 - 2018,28045,28045,2018,2016,2,1,1,0.081,0.038,0.849,98.436,24,24,46030,46655,1917,1943,35305,36505,1471,1521,26,50
2018 - 2022,28045,28045,2022,2020,23,12,11,0.074,0.039,0.844,97.075,0,25,47340,46010,,1840,37430,36720,,1468,,
2012 - 2014,28047,28047,2014,2012,11,6,5,0.226,0.053,0.662,337.356,56,57,188110,193640,3359,3397,137305,141605,2451,2484,38,33
2014 - 2016,28047,28047,2016,2014,18,9,9,0.237,0.053,0.653,345.927,57,57,193640,198570,3397,3483,141605,145875,2484,2559,86,75
2016 - 2018,28047,28047,2018,2016,21,8,13,0.244,0.054,0.643,353.226,57,52,198570,202625,3483,3896,145875,149055,2559,2866,413,307
2018 - 2022,28047,28047,2022,2020,53,27,26,0.249,0.056,0.628,363.907,0,53,206170,208750,,3938,153470,156000,,2943,,
2012 - 2014,28049,28049,2014,2012,20,10,10,0.699,0.015,0.271,283.253,112,112,246335,246365,2199,2199,178475,180500,1593,1611,0,18
2014 - 2016,28049,28049,2016,2014,26,7,19,0.711,0.015,0.258,281.220,112,100,246365,244595,2199,2445,180500,180735,1611,1807,246,196
2016 - 2018,28049,28049,2018,2016,26,9,17,0.720,0.015,0.250,277.975,100,92,244595,241775,2445,2627,180735,179830,1807,1954,182,147
2018 - 2022,28049,28049,2022,2020,97,56,41,0.729,0.016,0.238,260.437,0,107,235605,226540,,2117,176420,170920,,1597,,
2012 - 2014,28051,28051,2014,2012,16,16,0,0.826,0.002,0.163,25.063,1,17,19205,18965,19205,1115,13640,13715,13640,806,18090,12834
2014 - 2016,28051,28051,2016,2014,3,1,2,0.832,0.003,0.157,24.509,17,16,18965,18545,1115,1159,13715,13505,806,844,44,38
2016 - 2018,28051,28051,2018,2016,6,4,2,0.839,0.002,0.157,23.887,16,18,18545,18075,1159,1004,13505,13345,844,741,155,103
2018 - 2022,28051,28051,2022,2020,5,2,3,0.830,0.005,0.151,22.269,0,17,17415,16850,,991,12970,12625,,742,,
2014 - 2016,28053,28053,2016,2014,10,10,0,0.756,0.027,0.215,21.075,0,10,9105,8820,,882,6540,6345,,634,,
2016 - 2018,28053,28053,2018,2016,2,1,1,0.758,0.031,0.208,20.406,10,10,8820,8540,882,854,6345,6155,634,615,28,19
2018 - 2022,28053,28053,2022,2020,2,1,1,0.786,0.003,0.200,18.499,0,10,8200,7745,,774,5970,5720,,572,,
2012 - 2014,28055,28055,2014,2012,4,3,1,0.668,0.003,0.332,3.099,1,3,1555,1280,1555,426,1290,1085,1290,361,1129,929
2014 - 2016,28055,28055,2016,2014,3,1,2,0.604,0.007,0.393,3.268,3,2,1280,1350,426,675,1085,1145,361,572,249,211
2016 - 2018,28055,28055,2018,2016,2,1,1,0.602,0.011,0.387,3.220,2,2,1350,1330,675,665,1145,1130,572,565,10,7
2018 - 2022,28055,28055,2022,2020,1,0,1,0.705,0.008,0.278,2.918,0,1,1225,1205,,1205,1055,1080,,1080,,
2012 - 2014,28057,28057,2014,2012,1,1,0,0.065,0.014,0.913,43.948,0,1,23360,23415,,23415,17965,18065,,18065,,
2014 - 2016,28057,28057,2016,2014,4,3,1,0.066,0.014,0.909,44.126,1,3,23415,23510,23415,7836,18065,18155,18065,6051,15579,12014
2016 - 2018,28057,28057,2018,2016,21,21,0,0.071,0.015,0.902,44.069,3,24,23510,23480,7836,978,18155,18205,6051,758,6858,5293
2018 - 2022,28057,28057,2022,2020,16,8,8,0.060,0.018,0.890,44.839,0,24,23395,23890,,995,18295,18780,,782,,
2012 - 2014,28059,28059,2014,2012,5,3,2,0.216,0.051,0.692,193.974,30,31,139430,140195,4647,4522,101735,103150,3391,3327,125,64
2014 - 2016,28059,28059,2016,2014,2,1,1,0.214,0.055,0.687,194.880,31,31,140195,140850,4522,4543,103150,104100,3327,3358,21,31
2016 - 2018,28059,28059,2018,2016,16,5,11,0.213,0.063,0.680,196.480,31,25,140850,142015,4543,5680,104100,105815,3358,4232,1137,874
2018 - 2022,28059,28059,2022,2020,32,19,13,0.206,0.071,0.672,198.831,0,31,142870,143720,,4636,107970,109155,,3521,,
2012 - 2014,28061,28061,2014,2012,0,0,0,0.526,0.009,0.459,24.673,17,17,17035,16685,1002,981,12805,12710,753,747,21,6
2014 - 2016,28061,28061,2016,2014,1,0,1,0.536,0.003,0.456,24.459,17,16,16685,16540,981,1033,12710,12685,747,792,52,45
2016 - 2018,28061,28061,2018,2016,0,0,0,0.544,0.004,0.448,24.444,16,16,16540,16530,1033,1033,12685,12750,792,796,0,4
2018 - 2022,28061,28061,2022,2020,5,3,2,0.538,0.008,0.441,24.131,0,17,16455,16320,,960,12735,12575,,739,,
2012 - 2014,28063,28063,2014,2012,5,2,3,0.859,0.000,0.138,14.685,11,10,7745,7635,704,763,5890,5815,535,581,59,46
2014 - 2016,28063,28063,2016,2014,2,0,2,0.862,0.001,0.132,14.483,10,8,7635,7530,763,941,5815,5760,581,720,178,139
2016 - 2018,28063,28063,2018,2016,4,2,2,0.859,0.004,0.131,14.127,8,8,7530,7345,941,918,5760,5640,720,705,23,15
2018 - 2022,28063,28063,2022,2020,2,1,1,0.772,0.085,0.130,13.858,0,8,7130,7205,,900,5515,5600,,700,,
2012 - 2014,28065,28065,2014,2012,6,6,0,0.610,0.002,0.384,29.624,3,9,12365,12100,4121,1344,9480,9425,3160,1047,2777,2113
2014 - 2016,28065,28065,2016,2014,11,9,2,0.613,0.003,0.382,28.817,9,16,12100,11770,1344,735,9425,9290,1047,580,609,467
2016 - 2018,28065,28065,2018,2016,3,2,1,0.612,0.003,0.377,28.143,16,17,11770,11495,735,676,9290,9155,580,538,59,42
2018 - 2022,28065,28065,2022,2020,9,4,5,0.611,0.002,0.376,27.641,0,16,11180,11290,,705,8945,9050,,565,,
2012 - 2014,28067,28067,2014,2012,16,5,11,0.286,0.044,0.654,98.264,27,21,67870,68275,2513,3251,48765,49300,1806,2347,738,541
2014 - 2016,28067,28067,2016,2014,1,1,0,0.290,0.042,0.651,98.321,21,22,68275,68315,3251,3105,49300,49490,2347,2249,146,98
2016 - 2018,28067,28067,2018,2016,2,1,1,0.291,0.044,0.648,98.523,22,22,68315,68455,3105,3111,49490,49455,2249,2247,6,2
2018 - 2022,28067,28067,2022,2020,47,31,16,0.289,0.047,0.643,96.640,0,37,68305,67150,,1814,49800,49280,,1331,,
2012 - 2014,28069,28069,2014,2012,0,0,0,0.580,0.029,0.348,13.457,2,2,10390,10310,5195,5155,7930,7990,3965,3995,40,30
2014 - 2016,28069,28069,2016,2014,10,10,0,0.603,0.015,0.340,13.221,2,12,10310,10130,5155,844,7990,8005,3995,667,4311,3328
2016 - 2018,28069,28069,2018,2016,12,0,12,0.609,0.013,0.340,13.189,12,0,10130,10105,844,,8005,8160,667,,,
2018 - 2022,28069,28069,2022,2020,11,11,0,0.618,0.008,0.334,11.720,0,11,9830,8980,,816,7985,7335,,666,,
2012 - 2014,28071,28071,2014,2012,2,1,1,0.242,0.023,0.704,79.553,18,18,47585,50255,2643,2791,37640,40200,2091,2233,148,142
2014 - 2016,28071,28071,2016,2014,2,1,1,0.239,0.024,0.706,82.624,18,18,50255,52195,2791,2899,40200,41790,2233,2321,108,88
2016 - 2018,28071,28071,2018,2016,7,3,4,0.237,0.026,0.704,84.630,18,17,52195,53460,2899,3144,41790,42570,2321,2504,245,183
2018 - 2022,28071,28071,2022,2020,13,7,6,0.233,0.026,0.703,88.919,0,18,54060,56170,,3120,42820,44810,,2489,,
2012 - 2014,28073,28073,2014,2012,3,1,2,0.201,0.023,0.752,116.749,2,1,55580,58040,27790,58040,40295,42145,20147,42145,30250,21998
2014 - 2016,28073,28073,2016,2014,22,21,1,0.199,0.025,0.749,119.944,1,21,58040,59625,58040,2839,42145,43520,42145,2072,55201,40073
2016 - 2018,28073,28073,2018,2016,3,2,1,0.200,0.026,0.744,123.270,21,22,59625,61225,2839,2782,43520,45035,2072,2047,57,25
2018 - 2022,28073,28073,2022,2020,10,6,4,0.209,0.031,0.725,129.740,0,24,62695,64425,,2684,46410,48035,,2001,,
2012 - 2014,28075,28075,2014,2012,15,5,10,0.423,0.020,0.536,114.062,47,42,80205,80260,1706,1910,59390,60065,1263,1430,204,167
2014 - 2016,28075,28075,2016,2014,8,3,5,0.426,0.022,0.532,112.605,42,40,80260,79235,1910,1980,60065,59510,1430,1487,70,57
2016 - 2018,28075,28075,2018,2016,14,7,7,0.434,0.023,0.528,109.890,40,40,79235,77325,1980,1933,59510,58090,1487,1452,47,35
2018 - 2022,28075,28075,2022,2020,42,20,22,0.436,0.022,0.515,103.372,0,38,75555,72740,,1914,57070,55105,,1450,,
2012 - 2014,28077,28077,2014,2012,0,0,0,0.323,0.007,0.661,29.338,21,21,12830,12635,610,601,9595,9535,456,454,9,2
2014 - 2016,28077,28077,2016,2014,0,0,0,0.330,0.006,0.656,29.268,21,21,12635,12605,601,600,9535,9510,454,452,1,2
2016 - 2018,28077,28077,2018,2016,19,9,10,0.332,0.006,0.652,29.326,21,20,12605,12630,600,631,9510,9505,452,475,31,23
2018 - 2022,28077,28077,2022,2020,1,1,0,0.315,0.023,0.641,27.717,0,21,12595,11935,,568,9470,8870,,422,,
2012 - 2014,28079,28079,2014,2012,1,1,0,0.414,0.043,0.483,40.086,17,18,23565,23370,1386,1298,15845,16025,932,890,88,42
2014 - 2016,28079,28079,2016,2014,18,0,18,0.415,0.043,0.477,39.468,18,0,23370,23010,1298,,16025,16125,890,,,
2016 - 2018,28079,28079,2018,2016,18,18,0,0.418,0.045,0.472,39.235,0,18,23010,22870,,1270,16125,16430,,912,,
2018 - 2022,28079,28079,2022,2020,15,8,7,0.397,0.052,0.478,36.602,0,19,22790,21335,,1122,16615,16040,,844,,
2012 - 2014,28081,28081,2014,2012,11,5,6,0.278,0.025,0.678,187.998,33,32,83235,84590,2522,2643,60245,61455,1825,1920,121,95
2014 - 2016,28081,28081,2016,2014,3,2,1,0.286,0.024,0.670,189.532,32,33,84590,85280,2643,2584,61455,62215,1920,1885,59,35
2016 - 2018,28081,28081,2018,2016,12,3,9,0.294,0.026,0.660,188.721,33,27,85280,84915,2584,3145,62215,61940,1885,2294,561,409
2018 - 2022,28081,28081,2022,2020,30,18,12,0.302,0.030,0.640,185.225,0,33,85305,83345,,2525,62660,61285,,1857,,
2012 - 2014,28083,28083,2014,2012,1,1,0,0.714,0.024,0.243,53.543,17,18,32195,31770,1893,1765,22695,22550,1335,1252,128,83
2014 - 2016,28083,28083,2016,2014,3,2,1,0.728,0.025,0.234,51.402,18,19,31770,30500,1765,1605,22550,21690,1252,1141,160,111
2016 - 2018,28083,28083,2018,2016,2,0,2,0.734,0.026,0.225,50.170,19,17,30500,29805,1605,1753,21690,21160,1141,1244,148,103
2018 - 2022,28083,28083,2022,2020,6,3,3,0.746,0.029,0.215,46.997,0,17,28765,27920,,1642,20625,20030,,1178,,
2012 - 2014,28085,28085,2014,2012,36,28,8,0.307,0.011,0.674,59.416,9,29,34850,34825,3872,1200,25565,25860,2840,891,2672,1949
2014 - 2016,28085,28085,2016,2014,28,1,27,0.308,0.010,0.672,59.185,29,3,34825,34690,1200,11563,25860,26080,891,8693,10363,7802
2016 - 2018,28085,28085,2018,2016,27,26,1,0.311,0.011,0.673,58.741,3,28,34690,34430,11563,1229,26080,25960,8693,927,10334,7766
2018 - 2022,28085,28085,2022,2020,32,17,15,0.302,0.013,0.672,59.458,0,30,34195,34855,,1161,26010,26650,,888,,
2012 - 2014,28087,28087,2014,2012,2,1,1,0.441,0.017,0.530,118.185,21,21,59585,59735,2837,2844,44090,44455,2099,2116,7,17
2014 - 2016,28087,28087,2016,2014,5,2,3,0.435,0.019,0.525,118.284,21,20,59735,59785,2844,2989,44455,44810,2116,2240,145,124
2016 - 2018,28087,28087,2018,2016,7,4,3,0.437,0.020,0.520,117.590,20,21,59785,59435,2989,2830,44810,44730,2240,2130,159,110
2018 - 2022,28087,28087,2022,2020,15,7,8,0.446,0.024,0.505,115.828,0,20,58895,58545,,2927,44350,44040,,2202,,
2012 - 2014,28089,28089,2014,2012,18,10,8,0.382,0.029,0.559,138.063,36,38,95480,98620,2652,2595,67530,70710,1875,1860,57,15
2014 - 2016,28089,28089,2016,2014,25,6,19,0.382,0.028,0.560,142.501,38,25,98620,101790,2595,4071,70710,73690,1860,2947,1476,1087
2016 - 2018,28089,28089,2018,2016,23,20,3,0.380,0.030,0.557,144.854,25,42,101790,103500,4071,2464,73690,75115,2947,1788,1607,1159
2018 - 2022,28089,28089,2022,2020,60,30,30,0.376,0.031,0.553,152.942,0,42,105480,109255,,2601,77025,80405,,1914,,
2012 - 2014,28091,28091,2014,2012,10,5,5,0.322,0.013,0.651,48.766,23,23,26810,26450,1165,1150,19855,19775,863,859,15,4
2014 - 2016,28091,28091,2016,2014,4,2,2,0.322,0.014,0.651,47.586,23,23,26450,25810,1150,1122,19775,19490,859,847,28,12
2016 - 2018,28091,28091,2018,2016,5,2,3,0.322,0.015,0.651,46.461,23,22,25810,25200,1122,1145,19490,19060,847,866,23,19
2018 - 2022,28091,28091,2022,2020,11,5,6,0.323,0.017,0.652,44.912,0,21,24785,24360,,1160,18910,18650,,888,,
2012 - 2014,28093,28093,2014,2012,0,0,0,0.470,0.033,0.485,51.878,24,24,37020,36635,1542,1526,27740,28065,1155,1169,16,14
2014 - 2016,28093,28093,2016,2014,3,1,2,0.478,0.034,0.479,51.255,24,23,36635,36195,1526,1573,28065,27865,1169,1211,47,42
2016 - 2018,28093,28093,2018,2016,1,1,0,0.478,0.036,0.477,50.674,23,24,36195,35785,1573,1491,27865,27760,1211,1156,82,55
2018 - 2022,28093,28093,2022,2020,10,4,6,0.458,0.043,0.479,48.118,0,22,35500,33980,,1544,27615,26740,,1215,,
2012 - 2014,28095,28095,2014,2012,5,3,2,0.308,0.010,0.672,47.556,21,22,36910,36385,1757,1653,27910,27775,1329,1262,104,67
2014 - 2016,28095,28095,2016,2014,22,0,22,0.305,0.011,0.671,47.092,22,0,36385,36030,1653,,27775,27520,1262,,,
2016 - 2018,28095,28095,2018,2016,23,23,0,0.308,0.012,0.670,46.844,0,23,36030,35840,,1558,27520,27520,,1196,,
2018 - 2022,28095,28095,2022,2020,17,9,8,0.301,0.015,0.667,44.661,0,24,35560,34170,,1423,27470,26315,,1096,,
2012 - 2014,28097,28097,2014,2012,8,8,0,0.471,0.000,0.526,26.131,0,8,10865,10635,,1329,8215,8130,,1016,,
2014 - 2016,28097,28097,2016,2014,9,6,3,0.448,0.014,0.523,25.443,8,11,10635,10355,1329,941,8130,7935,1016,721,388,295
2016 - 2018,28097,28097,2018,2016,3,2,1,0.433,0.013,0.522,25.063,11,12,10355,10200,941,850,7935,7795,721,649,91,72
2018 - 2022,28097,28097,2022,2020,5,3,2,0.459,0.006,0.521,24.092,0,13,9955,9805,,754,7625,7545,,580,,
2012 - 2014,28099,28099,2014,2012,0,0,0,0.214,0.018,0.595,51.909,21,21,29680,29595,1413,1409,20980,20890,999,994,4,5
2014 - 2016,28099,28099,2016,2014,2,2,0,0.212,0.019,0.592,51.698,21,23,29595,29475,1409,1281,20890,20905,994,908,128,86
2016 - 2018,28099,28099,2018,2016,4,1,3,0.211,0.020,0.587,51.523,23,21,29475,29375,1281,1398,20905,20890,908,994,117,86
2018 - 2022,28099,28099,2022,2020,10,5,5,0.235,0.002,0.577,50.813,0,21,29250,28970,,1379,20895,20880,,994,,
2012 - 2014,28101,28101,2014,2012,5,1,4,0.305,0.015,0.626,37.501,20,17,21685,21670,1084,1274,15980,16115,799,947,190,148
2014 - 2016,28101,28101,2016,2014,4,2,2,0.303,0.017,0.620,37.466,17,17,21670,21650,1274,1273,16115,16045,947,943,1,4
2016 - 2018,28101,28101,2018,2016,5,3,2,0.304,0.019,0.611,37.250,17,18,21650,21525,1273,1195,16045,15920,943,884,78,59
2018 - 2022,28101,28101,2022,2020,9,4,5,0.313,0.021,0.600,36.823,0,17,21215,21275,,1251,15920,16150,,950,,
2012 - 2014,28103,28103,2014,2012,2,2,0,0.719,0.009,0.266,16.169,0,2,11510,11240,,5620,8315,8175,,4087,,
2014 - 2016,28103,28103,2016,2014,7,6,1,0.692,0.040,0.264,15.968,2,7,11240,11100,5620,1585,8175,8055,4087,1150,4035,2937
2016 - 2018,28103,28103,2018,2016,2,1,1,0.722,0.014,0.259,15.579,7,7,11100,10830,1585,1547,8055,8020,1150,1145,38,5
2018 - 2022,28103,28103,2022,2020,3,2,1,0.736,0.003,0.255,14.759,0,8,10565,10260,,1282,7885,7670,,958,,
2012 - 2014,28105,28105,2014,2012,0,0,0,0.370,0.016,0.576,106.153,18,18,47485,48640,2638,2702,37790,38400,2099,2133,64,34
2014 - 2016,28105,28105,2016,2014,14,7,7,0.369,0.016,0.571,107.866,18,18,48640,49425,2702,2745,38400,39210,2133,2178,43,45
2016 - 2018,28105,28105,2018,2016,8,4,4,0.370,0.017,0.567,107.979,18,18,49425,49480,2745,2748,39210,39525,2178,2195,3,17
2018 - 2022,28105,28105,2022,2020,35,17,18,0.366,0.018,0.563,112.147,0,17,49595,51390,,3022,39355,40960,,2409,,
2012 - 2014,28107,28107,2014,2012,2,1,1,0.499,0.016,0.482,50.362,24,24,34675,34505,1444,1437,25110,25225,1046,1051,7,5
2014 - 2016,28107,28107,2016,2014,2,2,0,0.501,0.016,0.475,50.092,24,26,34505,34320,1437,1320,25225,25200,1051,969,117,82
2016 - 2018,28107,28107,2018,2016,6,1,5,0.500,0.020,0.470,49.980,26,22,34320,34245,1320,1556,25200,25265,969,1148,236,179
2018 - 2022,28107,28107,2022,2020,8,4,4,0.497,0.006,0.469,48.389,0,22,34080,33155,,1507,25300,25000,,1136,,
2012 - 2014,28109,28109,2014,2012,0,0,0,0.133,0.030,0.820,68.191,2,2,55885,55295,27942,27647,41745,41530,20872,20765,295,107
2014 - 2016,28109,28109,2016,2014,30,28,2,0.130,0.029,0.821,68.031,2,28,55295,55165,27647,1970,41530,41865,20765,1495,25677,19270
2016 - 2018,28109,28109,2018,2016,19,6,13,0.128,0.030,0.819,67.976,28,21,55165,55150,1970,2626,41865,42290,1495,2013,656,518
2018 - 2022,28109,28109,2022,2020,5,3,2,0.125,0.034,0.818,69.455,0,22,55510,56350,,2561,42760,43415,,1973,,
2012 - 2014,28111,28111,2014,2012,1,1,0,0.216,0.000,0.774,18.812,15,16,12215,12175,814,760,9125,9230,608,576,54,32
2014 - 2016,28111,28111,2016,2014,0,0,0,0.200,0.013,0.777,18.812,16,16,12175,12175,760,760,9230,9295,576,580,0,4
2016 - 2018,28111,28111,2018,2016,2,0,2,0.197,0.015,0.774,18.588,16,14,12175,12030,760,859,9295,9215,580,658,99,78
2018 - 2022,28111,28111,2022,2020,5,3,2,0.116,0.070,0.775,17.782,0,15,11980,11510,,767,9225,8925,,595,,
2012 - 2014,28113,28113,2014,2012,13,4,9,0.520,0.013,0.453,98.309,29,24,40300,40210,1389,1675,29165,29195,1005,1216,286,211
2014 - 2016,28113,28113,2016,2014,11,6,5,0.528,0.014,0.444,97.649,24,25,40210,39940,1675,1597,29195,29075,1216,1163,78,53
2016 - 2018,28113,28113,2018,2016,11,5,6,0.533,0.017,0.436,97.147,25,24,39940,39735,1597,1655,29075,29185,1163,1216,58,53
2018 - 2022,28113,28113,2022,2020,8,3,5,0.540,0.016,0.424,98.000,0,22,39365,40100,,1822,28970,29735,,1351,,
2012 - 2014,28115,28115,2014,2012,11,6,5,0.146,0.061,0.778,61.026,25,26,29960,30375,1198,1168,21205,21840,848,840,30,8
2014 - 2016,28115,28115,2016,2014,25,0,25,0.151,0.061,0.775,62.000,26,1,30375,30860,1168,30860,21840,21960,840,21960,29692,21120
2016 - 2018,28115,28115,2018,2016,26,26,0,0.154,0.066,0.770,62.911,1,27,30860,31315,30860,1159,21960,22135,21960,819,29701,21141
2018 - 2022,28115,28115,2022,2020,20,9,11,0.145,0.075,0.755,62.674,0,25,31995,31200,,1248,22655,22290,,891,,
2012 - 2014,28117,28117,2014,2012,1,1,0,0.141,0.013,0.835,61.064,13,14,25385,25340,1952,1810,19240,19340,1480,1381,142,99
2014 - 2016,28117,28117,2016,2014,6,2,4,0.134,0.013,0.833,61.064,14,12,25340,25340,1810,2111,19340,19440,1381,1620,301,239
2016 - 2018,28117,28117,2018,2016,6,3,3,0.123,0.014,0.829,61.111,12,12,25340,25360,2111,2113,19440,19600,1620,1633,2,13
2018 - 2022,28117,28117,2022,2020,6,3,3,0.108,0.015,0.818,60.111,0,12,25155,24945,,2078,19105,19225,,1602,,
2012 - 2014,28119,28119,2014,2012,0,0,0,0.696,0.011,0.285,19.506,8,8,8170,7900,1021,987,5950,5795,743,724,34,19
2014 - 2016,28119,28119,2016,2014,0,0,0,0.705,0.012,0.278,18.851,8,8,7900,7635,987,954,5795,5675,724,709,33,15
2016 - 2018,28119,28119,2018,2016,2,1,1,0.716,0.014,0.267,18.197,8,8,7635,7370,954,921,5675,5560,709,695,33,14
2018 - 2022,28119,28119,2022,2020,0,0,0,0.720,0.004,0.248,15.098,0,8,7040,6115,,764,5390,4710,,588,,
2012 - 2014,28121,28121,2014,2012,6,5,1,0.194,0.026,0.756,187.623,50,54,142135,145485,2842,2694,104730,107715,2094,1994,148,100
2014 - 2016,28121,28121,2016,2014,14,4,10,0.199,0.025,0.753,190.775,54,48,145485,147930,2694,3081,107715,110035,1994,2292,387,298
2016 - 2018,28121,28121,2018,2016,7,3,4,0.205,0.027,0.744,195.015,48,47,147930,151240,3081,3217,110035,113250,2292,2409,136,117
2018 - 2022,28121,28121,2022,2020,55,26,29,0.216,0.027,0.729,202.690,0,44,154120,157185,,3572,116660,119820,,2723,,
2012 - 2014,28123,28123,2014,2012,1,1,0,0.375,0.106,0.508,46.468,24,25,28205,28310,1175,1132,18925,19030,788,761,43,27
2014 - 2016,28123,28123,2016,2014,10,0,10,0.376,0.108,0.501,46.403,25,15,28310,28270,1132,1884,19030,19105,761,1273,752,512
2016 - 2018,28123,28123,2018,2016,9,8,1,0.382,0.111,0.496,46.641,15,22,28270,28415,1884,1291,19105,19285,1273,876,593,397
2018 - 2022,28123,28123,2022,2020,8,5,3,0.357,0.118,0.489,45.869,0,24,28290,27945,,1164,19590,19275,,803,,
2014 - 2016,28125,28125,2016,2014,9,9,0,0.736,0.004,0.255,10.794,0,9,4900,4660,,517,3640,3470,,385,,
2016 - 2018,28125,28125,2018,2016,0,0,0,0.739,0.001,0.252,10.447,9,9,4660,4510,517,501,3470,3360,385,373,16,12
2018 - 2022,28125,28125,2022,2020,2,1,1,0.725,0.008,0.265,9.057,0,9,4425,3910,,434,3365,2975,,330,,
2012 - 2014,28127,28127,2014,2012,0,0,0,0.350,0.016,0.620,46.549,15,15,27475,27425,1831,1828,19905,20010,1327,1334,3,7
2014 - 2016,28127,28127,2016,2014,2,1,1,0.355,0.018,0.616,46.303,15,15,27425,27280,1828,1818,20010,20255,1334,1350,10,16
2016 - 2018,28127,28127,2018,2016,0,0,0,0.365,0.004,0.616,45.955,15,15,27280,27075,1818,1805,20255,20430,1350,1362,13,12
2018 - 2022,28127,28127,2022,2020,15,8,7,0.351,0.020,0.613,43.944,0,16,26820,25890,,1618,20430,19570,,1223,,
2012 - 2014,28129,28129,2014,2012,0,0,0,0.247,0.002,0.748,25.689,1,1,16425,16345,16425,16345,12165,12270,12165,12270,80,105
2014 - 2016,28129,28129,2016,2014,13,13,0,0.248,0.003,0.746,25.359,1,14,16345,16135,16345,1152,12270,12220,12270,872,15193,11398
2016 - 2018,28129,28129,2018,2016,0,0,0,0.231,0.017,0.742,25.249,14,14,16135,16065,1152,1147,12220,12140,872,867,5,5
2018 - 2022,28129,28129,2022,2020,2,1,1,0.243,0.005,0.736,22.491,0,14,15920,14310,,1022,12155,10975,,783,,
2012 - 2014,28131,28131,2014,2012,2,1,1,0.186,0.016,0.772,40.271,14,14,17655,17940,1261,1281,13240,13610,945,972,20,27
2014 - 2016,28131,28131,2016,2014,12,2,10,0.194,0.018,0.770,40.394,14,6,17940,17995,1281,2999,13610,13775,972,2295,1718,1323
2016 - 2018,28131,28131,2018,2016,7,7,0,0.193,0.020,0.763,41.247,6,13,17995,18375,2999,1413,13775,14265,2295,1097,1586,1198
2018 - 2022,28131,28131,2022,2020,13,4,9,0.163,0.023,0.768,41.214,0,8,18280,18360,,2295,14270,14365,,1795,,
2012 - 2014,28133,28133,2014,2012,3,2,1,0.728,0.014,0.251,40.580,14,15,29230,28315,2087,1887,22080,21535,1577,1435,200,142
2014 - 2016,28133,28133,2016,2014,5,2,3,0.735,0.016,0.245,39.304,15,14,28315,27425,1887,1958,21535,20925,1435,1494,71,59
2016 - 2018,28133,28133,2018,2016,6,4,2,0.739,0.017,0.240,38.022,14,16,27425,26530,1958,1658,20925,20405,1494,1275,300,219
2018 - 2022,28133,28133,2022,2020,10,5,5,0.736,0.019,0.237,37.069,0,16,25760,25865,,1616,20040,20125,,1257,,
2012 - 2014,28135,28135,2014,2012,0,0,0,0.476,0.139,0.363,23.442,15,15,15260,15125,1017,1008,11320,11040,754,736,9,18
2014 - 2016,28135,28135,2016,2014,5,4,1,0.466,0.152,0.358,22.899,15,18,15125,14775,1008,820,11040,11050,736,613,188,123
2016 - 2018,28135,28135,2018,2016,4,1,3,0.493,0.138,0.352,22.256,18,16,14775,14360,820,897,11050,10895,613,680,77,67
2018 - 2022,28135,28135,2022,2020,2,1,1,0.615,0.019,0.353,19.548,0,16,14040,12620,,788,11060,9865,,616,,
2012 - 2014,28137,28137,2014,2012,6,4,2,0.306,0.024,0.655,70.548,18,20,28580,28555,1587,1427,21025,21195,1168,1059,160,109
2014 - 2016,28137,28137,2016,2014,2,1,1,0.306,0.025,0.650,70.016,20,20,28555,28340,1427,1417,21195,21115,1059,1055,10,4
2016 - 2018,28137,28137,2018,2016,3,1,2,0.293,0.027,0.646,70.399,20,19,28340,28495,1417,1499,21115,21565,1055,1135,82,80
2018 - 2022,28137,28137,2022,2020,3,2,1,0.304,0.034,0.643,69.411,0,20,28420,28095,,1404,21645,21460,,1073,,
2012 - 2014,28139,28139,2014,2012,0,0,0,0.148,0.048,0.778,48.208,23,23,22095,22070,960,959,16200,16165,704,702,1,2
2014 - 2016,28139,28139,2016,2014,2,0,2,0.165,0.048,0.775,48.186,23,21,22070,22060,959,1050,16165,16045,702,764,91,62
2016 - 2018,28139,28139,2018,2016,9,5,4,0.167,0.047,0.772,48.032,21,22,22060,21990,1050,999,16045,16270,764,739,51,25
2018 - 2022,28139,28139,2022,2020,24,13,11,0.149,0.048,0.771,47.551,0,24,21975,21770,,907,16465,16245,,676,,
2012 - 2014,28141,28141,2014,2012,9,2,7,0.025,0.027,0.935,46.028,17,12,19575,19530,1151,1627,14870,14880,874,1240,476,366
2014 - 2016,28141,28141,2016,2014,3,2,1,0.024,0.027,0.936,45.970,12,13,19530,19505,1627,1500,14880,14895,1240,1145,127,95
2016 - 2018,28141,28141,2018,2016,3,1,2,0.028,0.032,0.932,45.911,13,12,19505,19480,1500,1623,14895,14930,1145,1244,123,99
2018 - 2022,28141,28141,2022,2020,5,3,2,0.013,0.035,0.925,44.391,0,13,19395,18835,,1448,14930,14445,,1111,,
2012 - 2014,28143,28143,2014,2012,10,10,0,0.752,0.013,0.219,23.280,0,10,10715,10585,,1058,7230,7275,,727,,
2014 - 2016,28143,28143,2016,2014,0,0,0,0.774,0.017,0.201,22.884,10,10,10585,10405,1058,1040,7275,7145,727,714,18,13
2016 - 2018,28143,28143,2018,2016,2,0,2,0.785,0.008,0.192,22.367,10,8,10405,10170,1040,1271,7145,6930,714,866,231,152
2018 - 2022,28143,28143,2022,2020,14,8,6,0.803,0.013,0.183,21.547,0,10,9805,9785,,978,6920,6980,,698,,
2012 - 2014,28145,28145,2014,2012,1,1,0,0.138,0.045,0.793,66.254,18,19,27175,27535,1509,1449,19655,19880,1091,1046,60,45
2014 - 2016,28145,28145,2016,2014,1,0,1,0.144,0.044,0.789,67.348,19,18,27535,27990,1449,1555,19880,20350,1046,1130,106,84
2016 - 2018,28145,28145,2018,2016,6,3,3,0.146,0.043,0.785,68.225,18,18,27990,28355,1555,1575,20350,20805,1130,1155,20,25
2018 - 2022,28145,28145,2022,2020,16,9,7,0.161,0.046,0.774,67.083,0,20,28580,27880,,1394,20855,20350,,1017,,
2012 - 2014,28147,28147,2014,2012,1,0,1,0.444,0.017,0.529,37.443,19,18,15405,15125,810,840,11350,11180,597,621,30,24
2014 - 2016,28147,28147,2016,2014,8,4,4,0.457,0.005,0.529,36.665,18,18,15125,14810,840,822,11180,11125,621,618,18,3
2016 - 2018,28147,28147,2018,2016,6,1,5,0.459,0.006,0.527,36.145,18,14,14810,14600,822,1042,11125,11085,618,791,220,173
2018 - 2022,28147,28147,2022,2020,9,7,2,0.430,0.024,0.527,34.387,0,19,14425,13890,,731,11030,10605,,558,,
2012 - 2014,28149,28149,2014,2012,21,11,10,0.475,0.020,0.489,82.054,20,21,48420,48290,2421,2299,35610,35710,1780,1700,122,80
2014 - 2016,28149,28149,2016,2014,6,3,3,0.483,0.021,0.480,81.281,21,21,48290,47835,2299,2277,35710,35480,1700,1689,22,11
2016 - 2018,28149,28149,2018,2016,10,5,5,0.491,0.022,0.473,79.989,21,21,47835,47075,2277,2241,35480,35390,1689,1685,36,4
2018 - 2022,28149,28149,2022,2020,10,4,6,0.487,0.022,0.469,75.340,0,19,46030,44340,,2333,34695,33450,,1760,,
2012 - 2014,28151,28151,2014,2012,4,2,2,0.710,0.012,0.265,69.045,18,18,51010,50040,2833,2780,36225,36015,2012,2000,53,12
2014 - 2016,28151,28151,2016,2014,1,0,1,0.716,0.014,0.258,67.369,18,17,50040,48825,2780,2872,36015,35560,2000,2091,92,91
2016 - 2018,28151,28151,2018,2016,2,1,1,0.721,0.016,0.253,64.968,17,17,48825,47085,2872,2769,35560,34345,2091,2020,103,71
2018 - 2022,28151,28151,2022,2020,4,3,1,0.722,0.018,0.245,61.612,0,19,45070,44605,,2347,33330,33190,,1746,,
2012 - 2014,28153,28153,2014,2012,14,6,8,0.389,0.013,0.587,25.422,19,17,20755,20610,1092,1212,15300,15305,805,900,120,95
2014 - 2016,28153,28153,2016,2014,0,0,0,0.394,0.014,0.583,25.305,17,17,20610,20515,1212,1206,15305,15285,900,899,6,1
2016 - 2018,28153,28153,2018,2016,1,1,0,0.411,0.003,0.575,25.188,17,18,20515,20420,1206,1134,15285,15325,899,851,72,48
2018 - 2022,28153,28153,2022,2020,8,4,4,0.383,0.037,0.571,24.374,0,18,20345,19760,,1097,15120,14460,,803,,
2012 - 2014,28155,28155,2014,2012,1,1,0,0.193,0.012,0.778,23.935,15,16,10160,10075,677,629,7610,7585,507,474,48,33
2014 - 2016,28155,28155,2016,2014,4,2,2,0.193,0.014,0.781,23.566,16,16,10075,9920,629,620,7585,7515,474,469,9,5
2016 - 2018,28155,28155,2018,2016,2,1,1,0.193,0.015,0.781,23.353,16,16,9920,9830,620,614,7515,7460,469,466,6,3
2018 - 2022,28155,28155,2022,2020,16,6,10,0.185,0.016,0.785,23.602,0,12,9725,9940,,828,7420,7565,,630,,
2012 - 2014,28157,28157,2014,2012,0,0,0,0.711,0.001,0.287,13.980,4,4,9780,9480,2445,2370,7540,7365,1885,1841,75,44
2014 - 2016,28157,28157,2016,2014,7,6,1,0.715,0.003,0.280,13.619,4,9,9480,9235,2370,1026,7365,7205,1841,800,1344,1041
2016 - 2018,28157,28157,2018,2016,5,2,3,0.713,0.004,0.279,13.258,9,8,9235,8990,1026,1123,7205,7060,800,882,97,82
2018 - 2022,28157,28157,2022,2020,7,4,3,0.696,0.018,0.278,12.579,0,9,8725,8530,,947,6875,6750,,750,,
2012 - 2014,28159,28159,2014,2012,1,1,0,0.471,0.011,0.511,31.092,10,11,19160,18880,1916,1716,14400,14245,1440,1295,200,145
2014 - 2016,28159,28159,2016,2014,2,1,1,0.478,0.011,0.505,30.499,11,11,18880,18520,1716,1683,14245,14060,1295,1278,33,17
2016 - 2018,28159,28159,2018,2016,17,9,8,0.476,0.012,0.501,30.235,11,12,18520,18360,1683,1530,14060,14025,1278,1168,153,110
2018 - 2022,28159,28159,2022,2020,8,3,5,0.467,0.015,0.496,29.214,0,10,18115,17740,,1774,13990,13825,,1382,,
2014 - 2016,28161,28161,2016,2014,9,9,0,0.394,0.015,0.584,26.502,0,9,12435,12380,,1375,9480,9485,,1053,,
2016 - 2018,28161,28161,2018,2016,1,0,1,0.400,0.016,0.581,26.587,9,8,12380,12420,1375,1552,9485,9570,1053,1196,177,143
2018 - 2022,28161,28161,2022,2020,5,3,2,0.383,0.026,0.578,26.758,0,9,12275,12500,,1388,9520,9770,,1085,,
2012 - 2014,28163,28163,2014,2012,20,20,0,0.569,0.051,0.367,30.419,0,20,28220,28075,,1403,20055,19990,,999,,
2014 - 2016,28163,28163,2016,2014,2,2,0,0.587,0.036,0.360,30.060,20,22,28075,27720,1403,1260,19990,20275,999,921,143,78
2016 - 2018,28163,28163,2018,2016,3,0,3,0.563,0.065,0.351,30.330,22,19,27720,27975,1260,1472,20275,20115,921,1058,212,137
2018 - 2022,28163,28163,2022,2020,3,2,1,0.607,0.040,0.339,29.778,0,20,28510,27465,,1373,20830,21135,,1056,,
2012 - 2014,45001,45001,2014,2012,0,0,0,0.288,0.006,0.690,51.174,14,14,25385,25100,1813,1792,19410,19395,1386,1385,21,1
2014 - 2016,45001,45001,2016,2014,0,0,0,0.272,0.013,0.689,50.868,14,14,25100,24950,1792,1782,19395,19505,1385,1393,10,8
2016 - 2018,45001,45001,2018,2016,1,1,0,0.274,0.014,0.689,50.170,14,15,24950,24655,1782,1643,19505,19365,1393,1291,139,102
2018 - 2020,45001,45001,2020,2018,2,1,1,0.272,0.016,0.689,50.041,15,15,24655,24580,1643,1638,19365,19445,1291,1296,5,5
2020 - 2022,45001,45001,2022,2020,0,0,0,0.262,0.018,0.694,49.614,15,15,24580,24370,1638,1624,19445,19360,1296,1290,14,6
2012 - 2014,45003,45003,2014,2012,2,1,1,0.247,0.052,0.675,152.175,68,68,160170,162990,2355,2396,120340,123270,1769,1812,41,43
2014 - 2016,45003,45003,2016,2014,9,7,2,0.243,0.054,0.670,154.184,68,73,162990,165145,2396,2262,123270,124145,1812,1700,134,112
2016 - 2018,45003,45003,2018,2016,15,7,8,0.245,0.056,0.665,155.916,73,72,165145,166925,2262,2318,124145,125470,1700,1742,56,42
2018 - 2020,45003,45003,2020,2018,33,17,16,0.245,0.058,0.660,158.725,72,73,166925,169945,2318,2328,125470,129540,1742,1774,10,32
2020 - 2022,45003,45003,2022,2020,54,26,28,0.246,0.062,0.655,158.650,73,71,169945,169865,2328,2392,129540,131020,1774,1845,64,71
2012 - 2014,45005,45005,2014,2012,0,0,0,0.739,0.027,0.233,24.566,9,9,10400,10025,1155,1113,8015,7825,890,869,42,21
2014 - 2016,45005,45005,2016,2014,1,0,1,0.738,0.030,0.227,23.500,9,8,10025,9590,1113,1198,7825,7610,869,951,85,82
2016 - 2018,45005,45005,2018,2016,0,0,0,0.755,0.015,0.222,22.581,8,8,9590,9215,1198,1151,7610,7385,951,923,47,28
2018 - 2020,45005,45005,2020,2018,1,1,0,0.730,0.034,0.220,21.539,8,9,9215,8790,1151,976,7385,6980,923,775,175,148
2020 - 2022,45005,45005,2022,2020,4,1,3,0.719,0.037,0.222,19.787,9,7,8790,8075,976,1153,6980,6475,775,925,177,150
2012 - 2014,45007,45007,2014,2012,6,5,1,0.163,0.032,0.781,265.239,76,80,187230,189765,2463,2372,140000,142575,1842,1782,91,60
2014 - 2016,45007,45007,2016,2014,3,1,2,0.161,0.034,0.779,269.352,80,79,189765,192710,2372,2439,142575,145055,1782,1836,67,54
2016 - 2018,45007,45007,2018,2016,0,0,0,0.157,0.036,0.776,274.560,79,79,192710,195995,2439,2480,145055,147930,1836,1872,41,36
2018 - 2020,45007,45007,2020,2018,37,17,20,0.156,0.038,0.772,280.429,79,76,195995,200185,2480,2634,147930,151560,1872,1994,154,122
2020 - 2022,45007,45007,2022,2020,33,17,16,0.149,0.042,0.768,286.599,76,77,200185,204590,2634,2657,151560,154685,1994,2008,23,14
2012 - 2014,45009,45009,2014,2012,0,0,0,0.624,0.012,0.357,39.785,12,12,15940,15650,1328,1304,12305,12220,1025,1018,24,7
2014 - 2016,45009,45009,2016,2014,0,0,0,0.626,0.011,0.356,38.272,12,12,15650,15055,1304,1254,12220,11855,1018,987,50,31
2016 - 2018,45009,45009,2018,2016,0,0,0,0.611,0.020,0.359,37.115,12,12,15055,14600,1254,1216,11855,11515,987,959,38,28
2018 - 2020,45009,45009,2020,2018,1,1,0,0.590,0.021,0.361,36.188,12,13,14600,14235,1216,1095,11515,11160,959,858,121,101
2020 - 2022,45009,45009,2022,2020,0,0,0,0.604,0.017,0.366,33.836,13,13,14235,13310,1095,1023,11160,10540,858,810,72,48
2012 - 2014,45011,45011,2014,2012,0,0,0,0.445,0.022,0.516,40.638,10,10,22525,22285,2252,2228,16630,16530,1663,1653,24,10
2014 - 2016,45011,45011,2016,2014,2,0,2,0.449,0.022,0.513,39.963,10,8,22285,21915,2228,2739,16530,16320,1653,2040,511,387
2016 - 2018,45011,45011,2018,2016,0,0,0,0.456,0.024,0.511,39.343,8,8,21915,21575,2739,2696,16320,16100,2040,2012,43,28
2018 - 2020,45011,45011,2020,2018,5,3,2,0.445,0.026,0.511,38.605,8,9,21575,21170,2696,2352,16100,15935,2012,1770,344,242
2020 - 2022,45011,45011,2022,2020,0,0,0,0.440,0.028,0.509,37.666,9,9,21170,20655,2352,2295,15935,15575,1770,1730,57,40
2012 - 2014,45013,45013,2014,2012,20,8,12,0.186,0.117,0.667,292.322,60,56,162315,168455,2705,3008,117380,123860,1956,2211,303,255
2014 - 2016,45013,45013,2016,2014,10,5,5,0.182,0.113,0.673,304.226,56,56,168455,175315,3008,3130,123860,131055,2211,2340,122,129
2016 - 2018,45013,45013,2018,2016,8,4,4,0.179,0.112,0.678,317.022,56,56,175315,182660,3130,3261,131055,139160,2340,2485,131,145
2018 - 2020,45013,45013,2020,2018,15,7,8,0.172,0.111,0.683,329.371,56,55,182660,189730,3261,3449,139160,146680,2485,2666,188,181
2020 - 2022,45013,45013,2022,2020,46,25,21,0.163,0.112,0.687,328.221,55,59,189730,189070,3449,3204,146680,148060,2666,2509,245,157
2012 - 2014,45015,45015,2014,2012,7,5,2,0.246,0.060,0.641,171.836,44,47,179775,188835,4085,4017,129115,136820,2934,2911,68,23
2014 - 2016,45015,45015,2016,2014,8,7,1,0.242,0.061,0.642,181.158,47,53,188835,199080,4017,3756,136820,145580,2911,2746,261,165
2016 - 2018,45015,45015,2018,2016,3,2,1,0.239,0.065,0.639,189.438,53,54,199080,209065,3756,3871,145580,153030,2746,2833,115,87
2018 - 2020,45015,45015,2020,2018,12,9,3,0.232,0.068,0.635,201.251,54,60,209065,222105,3871,3701,153030,163865,2833,2731,170,102
2020 - 2022,45015,45015,2022,2020,19,9,10,0.232,0.073,0.629,209.688,60,59,222105,231420,3701,3922,163865,171730,2731,2910,221,179
2012 - 2014,45017,45017,2014,2012,0,0,0,0.422,0.032,0.532,39.433,12,12,15135,15030,1261,1252,11660,11680,971,973,9,2
2014 - 2016,45017,45017,2016,2014,0,0,0,0.418,0.035,0.535,39.053,12,12,15030,14885,1252,1240,11680,11640,973,970,12,3
2016 - 2018,45017,45017,2018,2016,0,0,0,0.413,0.037,0.538,38.607,12,12,14885,14715,1240,1226,11640,11660,970,971,14,1
2018 - 2020,45017,45017,2020,2018,1,1,0,0.407,0.039,0.540,38.331,12,13,14715,14610,1226,1123,11660,11665,971,897,103,74
2020 - 2022,45017,45017,2022,2020,0,0,0,0.389,0.042,0.544,37.111,13,13,14610,14145,1123,1088,11665,11395,897,876,35,21
2012 - 2014,45019,45019,2014,2012,20,9,11,0.288,0.052,0.628,399.139,106,104,352550,365675,3325,3516,267915,280400,2527,2696,191,169
2014 - 2016,45019,45019,2016,2014,15,6,9,0.281,0.050,0.637,414.928,104,101,365675,380675,3516,3769,280400,293755,2696,2908,253,212
2016 - 2018,45019,45019,2018,2016,17,5,12,0.271,0.051,0.643,430.005,101,94,380675,394710,3769,4199,293755,305280,2908,3247,430,339
2018 - 2020,45019,45019,2020,2018,27,15,12,0.261,0.052,0.650,443.959,94,97,394710,407545,4199,4201,305280,315640,3247,3254,2,7
2020 - 2022,45019,45019,2022,2020,38,20,18,0.247,0.054,0.657,446.411,97,99,407545,409840,4201,4139,315640,319010,3254,3222,62,32
2012 - 2014,45021,45021,2014,2012,0,0,0,0.200,0.039,0.736,141.866,30,30,55350,55705,1845,1856,40960,41490,1365,1383,11,18
2014 - 2016,45021,45021,2016,2014,15,7,8,0.200,0.040,0.733,143.307,30,29,55705,56275,1856,1940,41490,42310,1383,1458,84,75
2016 - 2018,45021,45021,2018,2016,0,0,0,0.200,0.042,0.730,144.177,29,29,56275,56710,1940,1955,42310,42815,1458,1476,15,18
2018 - 2020,45021,45021,2020,2018,7,4,3,0.200,0.045,0.726,145.332,29,30,56710,57110,1955,1903,42815,43035,1476,1434,52,42
2020 - 2022,45021,45021,2022,2020,5,2,3,0.196,0.049,0.722,143.016,30,29,57110,56200,1903,1937,43035,42525,1434,1466,34,32
2012 - 2014,45023,45023,2014,2012,1,1,0,0.374,0.016,0.590,56.333,20,21,33030,32710,1651,1557,24955,24885,1247,1185,94,62
2014 - 2016,45023,45023,2016,2014,0,0,0,0.373,0.018,0.589,55.859,21,21,32710,32435,1557,1544,24885,24850,1185,1183,13,2
2016 - 2018,45023,45023,2018,2016,0,0,0,0.369,0.020,0.588,55.670,21,21,32435,32325,1544,1539,24850,24845,1183,1183,5,0
2018 - 2020,45023,45023,2020,2018,4,2,2,0.368,0.021,0.585,55.557,21,21,32325,32260,1539,1536,24845,24900,1183,1185,3,2
2020 - 2022,45023,45023,2022,2020,2,1,1,0.361,0.024,0.586,55.402,21,21,32260,32170,1536,1531,24900,24855,1185,1183,5,2
2012 - 2014,45025,45025,2014,2012,0,0,0,0.328,0.038,0.616,57.985,23,23,46460,46335,2020,2014,34200,34600,1486,1504,6,18
2014 - 2016,45025,45025,2016,2014,0,0,0,0.321,0.041,0.610,57.675,23,23,46335,46085,2014,2003,34600,34500,1504,1500,11,4
2016 - 2018,45025,45025,2018,2016,0,0,0,0.322,0.042,0.606,57.607,23,23,46085,46025,2003,2001,34500,34640,1500,1506,2,6
2018 - 2020,45025,45025,2020,2018,6,4,2,0.305,0.044,0.602,57.366,23,25,46025,45835,2001,1833,34640,34910,1506,1396,168,110
2020 - 2022,45025,45025,2022,2020,0,0,0,0.308,0.049,0.596,54.488,25,25,45835,43535,1833,1741,34910,33250,1396,1330,92,66
2012 - 2014,45027,45027,2014,2012,0,0,0,0.492,0.028,0.468,56.744,25,25,34745,34440,1389,1377,26725,26745,1069,1069,12,0
2014 - 2016,45027,45027,2016,2014,1,0,1,0.485,0.029,0.473,56.109,25,24,34440,34055,1377,1418,26745,26695,1069,1112,41,43
2016 - 2018,45027,45027,2018,2016,0,0,0,0.485,0.030,0.476,56.042,24,24,34055,34015,1418,1417,26695,26870,1112,1119,1,7
2018 - 2020,45027,45027,2020,2018,18,6,12,0.466,0.032,0.480,55.772,24,18,34015,33865,1417,1881,26870,26935,1119,1496,464,377
2020 - 2022,45027,45027,2022,2020,1,1,0,0.456,0.034,0.487,51.325,18,19,33865,31165,1881,1640,26935,24880,1496,1309,241,187
2012 - 2014,45029,45029,2014,2012,1,1,0,0.384,0.029,0.562,36.200,27,28,38665,38245,1432,1365,28585,28515,1058,1018,67,40
2014 - 2016,45029,45029,2016,2014,3,1,2,0.379,0.030,0.564,35.859,28,27,38245,37885,1365,1403,28515,28690,1018,1062,38,44
2016 - 2018,45029,45029,2018,2016,1,1,0,0.383,0.032,0.565,35.561,27,28,37885,37570,1403,1341,28690,28510,1062,1018,62,44
2018 - 2020,45029,45029,2020,2018,3,2,1,0.382,0.035,0.568,35.613,28,29,37570,37625,1341,1297,28510,28695,1018,989,44,29
2020 - 2022,45029,45029,2022,2020,4,2,2,0.349,0.038,0.572,36.498,29,29,37625,38560,1297,1329,28695,29330,989,1011,32,22
2012 - 2014,45031,45031,2014,2012,0,0,0,0.406,0.018,0.554,121.466,33,33,68500,68160,2075,2065,51255,51245,1553,1552,10,1
2014 - 2016,45031,45031,2016,2014,1,0,1,0.407,0.018,0.552,120.627,33,32,68160,67690,2065,2115,51245,51285,1552,1602,50,50
2016 - 2018,45031,45031,2018,2016,0,0,0,0.407,0.020,0.549,119.962,32,32,67690,67255,2115,2101,51285,51445,1602,1607,14,5
2018 - 2020,45031,45031,2020,2018,5,3,2,0.409,0.021,0.545,119.268,32,33,67255,66860,2101,2026,51445,51430,1607,1558,75,49
2020 - 2022,45031,45031,2022,2020,8,4,4,0.409,0.024,0.541,112.421,33,33,66860,63025,2026,1909,51430,48620,1558,1473,117,85
2012 - 2014,45033,45033,2014,2012,0,0,0,0.459,0.025,0.471,77.883,21,21,31735,31530,1511,1501,22840,22770,1087,1084,10,3
2014 - 2016,45033,45033,2016,2014,0,0,0,0.455,0.027,0.466,77.253,21,21,31530,31275,1501,1489,22770,22775,1084,1084,12,0
2016 - 2018,45033,45033,2018,2016,0,0,0,0.467,0.027,0.458,76.210,21,21,31275,30870,1489,1470,22775,22525,1084,1072,19,12
2018 - 2020,45033,45033,2020,2018,6,3,3,0.477,0.028,0.455,75.235,21,21,30870,30475,1470,1451,22525,22665,1072,1079,19,7
2020 - 2022,45033,45033,2022,2020,2,1,1,0.464,0.031,0.452,69.752,21,21,30475,28255,1451,1345,22665,20845,1079,992,106,87
2012 - 2014,45035,45035,2014,2012,2,1,1,0.251,0.047,0.653,249.059,38,38,136835,142770,3600,3757,96930,102420,2550,2695,157,145
2014 - 2016,45035,45035,2016,2014,4,1,3,0.250,0.049,0.651,259.074,38,36,142770,148515,3757,4125,102420,107585,2695,2988,368,293
2016 - 2018,45035,45035,2018,2016,1,0,1,0.252,0.052,0.647,273.438,36,35,148515,155475,4125,4442,107585,113700,2988,3248,317,260
2018 - 2020,45035,45035,2020,2018,6,3,3,0.250,0.056,0.640,283.700,35,35,155475,161310,4442,4608,113700,117660,3248,3361,166,113
2020 - 2022,45035,45035,2022,2020,22,12,10,0.251,0.061,0.632,285.217,35,37,161310,162140,4608,4382,117660,118825,3361,3211,226,150
2012 - 2014,45037,45037,2014,2012,1,1,0,0.367,0.055,0.563,53.108,10,11,26765,26575,2676,2415,20200,20265,2020,1842,261,178
2014 - 2016,45037,45037,2016,2014,0,0,0,0.367,0.057,0.563,52.738,11,11,26575,26390,2415,2399,20265,20430,1842,1857,16,15
2016 - 2018,45037,45037,2018,2016,0,0,0,0.364,0.058,0.565,53.459,11,11,26390,26770,2399,2433,20430,21040,1857,1912,34,55
2018 - 2020,45037,45037,2020,2018,5,3,2,0.349,0.061,0.570,53.963,11,12,26770,27020,2433,2251,21040,21375,1912,1781,182,131
2020 - 2022,45037,45037,2022,2020,2,1,1,0.326,0.069,0.572,52.287,12,12,27020,26180,2251,2181,21375,20585,1781,1715,70,66
2012 - 2014,45039,45039,2014,2012,0,0,0,0.578,0.018,0.380,34.068,18,18,23805,23380,1322,1298,18310,17965,1017,998,24,19
2014 - 2016,45039,45039,2016,2014,0,0,0,0.566,0.019,0.378,33.551,18,18,23380,23025,1298,1279,17965,18075,998,1004,19,6
2016 - 2018,45039,45039,2018,2016,0,0,0,0.560,0.021,0.380,33.092,18,18,23025,22710,1279,1261,18075,18120,1004,1006,18,2
2018 - 2020,45039,45039,2020,2018,1,1,0,0.571,0.023,0.383,32.646,18,19,22710,22405,1261,1179,18120,18070,1006,951,82,55
2020 - 2022,45039,45039,2022,2020,0,0,0,0.559,0.026,0.387,30.511,19,19,22405,20940,1179,1102,18070,16995,951,894,77,57
2012 - 2014,45041,45041,2014,2012,1,0,1,0.414,0.023,0.535,172.583,63,62,136715,138060,2170,2226,101240,102545,1606,1653,56,47
2014 - 2016,45041,45041,2016,2014,4,1,3,0.419,0.024,0.529,173.227,62,60,138060,138575,2226,2309,102545,103355,1653,1722,83,69
2016 - 2018,45041,45041,2018,2016,7,3,4,0.423,0.025,0.523,173.090,60,59,138575,138560,2309,2348,103355,103815,1722,1759,39,37
2018 - 2020,45041,45041,2020,2018,19,9,10,0.428,0.027,0.516,172.685,59,58,138560,138235,2348,2383,103815,103655,1759,1787,35,28
2020 - 2022,45041,45041,2022,2020,41,22,19,0.429,0.029,0.509,171.161,58,61,138235,137015,2383,2246,103655,102920,1787,1687,137,100
2012 - 2014,45043,45043,2014,2012,0,0,0,0.331,0.031,0.626,74.230,32,32,60285,60390,1883,1887,46455,47065,1451,1470,4,19
2014 - 2016,45043,45043,2016,2014,0,0,0,0.317,0.030,0.632,74.737,32,32,60390,60805,1887,1900,47065,47975,1470,1499,13,29
2016 - 2018,45043,45043,2018,2016,1,1,0,0.312,0.031,0.638,75.692,32,33,60805,61605,1900,1866,47975,49005,1499,1485,34,14
2018 - 2020,45043,45043,2020,2018,12,5,7,0.308,0.031,0.645,76.388,33,31,61605,62150,1866,2004,49005,49945,1485,1611,138,126
2020 - 2022,45043,45043,2022,2020,16,9,7,0.294,0.032,0.656,78.163,31,33,62150,63595,2004,1927,49945,51735,1611,1567,77,44
2012 - 2014,45045,45045,2014,2012,15,7,8,0.181,0.085,0.698,594.924,150,149,452930,467085,3019,3134,320805,334705,2138,2246,115,108
2014 - 2016,45045,45045,2016,2014,12,7,5,0.181,0.087,0.694,614.128,149,151,467085,482190,3134,3193,334705,347080,2246,2298,59,52
2016 - 2018,45045,45045,2018,2016,2,1,1,0.179,0.090,0.688,634.854,151,151,482190,498400,3193,3300,347080,359180,2298,2378,107,80
2018 - 2020,45045,45045,2020,2018,26,10,16,0.175,0.094,0.682,656.703,151,145,498400,516125,3300,3559,359180,374005,2378,2579,259,201
2020 - 2022,45045,45045,2022,2020,108,51,57,0.171,0.099,0.676,672.129,145,139,516125,528250,3559,3800,374005,384530,2579,2766,241,187
2012 - 2014,45047,45047,2014,2012,4,4,0,0.306,0.056,0.608,153.300,44,48,69530,69710,1580,1452,51150,51505,1162,1073,128,89
2014 - 2016,45047,45047,2016,2014,1,0,1,0.311,0.058,0.603,153.673,48,47,69710,69880,1452,1486,51505,51810,1073,1102,34,29
2016 - 2018,45047,45047,2018,2016,2,2,0,0.316,0.060,0.598,154.522,47,49,69880,70265,1486,1433,51810,52415,1102,1069,53,33
2018 - 2020,45047,45047,2020,2018,18,7,11,0.322,0.062,0.595,155.113,49,45,70265,70670,1433,1570,52415,53020,1069,1178,137,109
2020 - 2022,45047,45047,2022,2020,14,9,5,0.315,0.065,0.592,152.128,45,49,70670,69310,1570,1414,53020,52535,1178,1072,156,106
2012 - 2014,45049,45049,2014,2012,0,0,0,0.536,0.038,0.413,36.918,15,15,20985,20670,1399,1378,15650,15585,1043,1039,21,4
2014 - 2016,45049,45049,2016,2014,0,0,0,0.555,0.022,0.411,36.248,15,15,20670,20295,1378,1353,15585,15525,1039,1035,25,4
2016 - 2018,45049,45049,2018,2016,0,0,0,0.537,0.040,0.409,35.368,15,15,20295,19805,1353,1320,15525,15165,1035,1011,33,24
2018 - 2020,45049,45049,2020,2018,1,1,0,0.531,0.039,0.412,34.332,15,16,19805,19225,1320,1201,15165,14765,1011,922,119,89
2020 - 2022,45049,45049,2022,2020,4,2,2,0.527,0.049,0.404,33.734,16,16,19225,18890,1201,1180,14765,14530,922,908,21,14
2012 - 2014,45051,45051,2014,2012,7,4,3,0.136,0.061,0.773,249.823,117,118,270945,283280,2315,2400,205305,215985,1754,1830,85,76
2014 - 2016,45051,45051,2016,2014,9,5,4,0.135,0.060,0.774,264.939,118,119,283280,300420,2400,2524,215985,231840,1830,1948,124,118
2016 - 2018,45051,45051,2018,2016,6,4,2,0.136,0.060,0.774,283.073,119,121,300420,320915,2524,2652,231840,250830,1948,2072,128,124
2018 - 2020,45051,45051,2020,2018,15,7,8,0.130,0.061,0.775,303.700,121,120,320915,344185,2652,2868,250830,270875,2072,2257,216,185
2020 - 2022,45051,45051,2022,2020,77,39,38,0.123,0.063,0.776,314.678,120,121,344185,356580,2868,2946,270875,283865,2257,2345,78,88
2012 - 2014,45053,45053,2014,2012,3,2,1,0.447,0.143,0.395,39.736,14,15,24790,26040,1770,1736,16840,18195,1202,1213,34,11
2014 - 2016,45053,45053,2016,2014,1,0,1,0.438,0.134,0.411,41.484,15,14,26040,27185,1736,1941,18195,19485,1213,1391,205,178
2016 - 2018,45053,45053,2018,2016,2,1,1,0.431,0.132,0.422,42.585,14,14,27185,27900,1941,1992,19485,20120,1391,1437,51,46
2018 - 2020,45053,45053,2020,2018,4,2,2,0.407,0.134,0.436,45.119,14,14,27900,29560,1992,2111,20120,21590,1437,1542,119,105
2020 - 2022,45053,45053,2022,2020,9,5,4,0.373,0.141,0.455,44.943,14,15,29560,29445,2111,1963,21590,21955,1542,1463,148,79
2012 - 2014,45055,45055,2014,2012,0,0,0,0.247,0.040,0.692,85.802,33,33,61585,62340,1866,1889,45385,46485,1375,1408,23,33
2014 - 2016,45055,45055,2016,2014,4,2,2,0.243,0.041,0.691,86.834,33,33,62340,63090,1889,1911,46485,47705,1408,1445,22,37
2016 - 2018,45055,45055,2018,2016,0,0,0,0.239,0.042,0.690,88.593,33,33,63090,64360,1911,1950,47705,48840,1445,1480,39,35
2018 - 2020,45055,45055,2020,2018,14,6,8,0.237,0.047,0.686,90.729,33,31,64360,65925,1950,2126,48840,49970,1480,1611,176,131
2020 - 2022,45055,45055,2022,2020,16,8,8,0.229,0.052,0.678,90.530,31,31,65925,65780,2126,2121,49970,49555,1611,1598,5,13
2012 - 2014,45057,45057,2014,2012,0,0,0,0.232,0.048,0.701,144.794,30,30,76365,79515,2545,2650,57560,60350,1918,2011,105,93
2014 - 2016,45057,45057,2016,2014,7,6,1,0.224,0.049,0.704,152.424,30,35,79515,83705,2650,2391,60350,63600,2011,1817,259,194
2016 - 2018,45057,45057,2018,2016,1,1,0,0.212,0.052,0.702,163.085,35,36,83705,89545,2391,2487,63600,68545,1817,1904,96,87
2018 - 2020,45057,45057,2020,2018,10,5,5,0.206,0.056,0.702,173.712,36,36,89545,95380,2487,2649,68545,72095,1904,2002,162,98
2020 - 2022,45057,45057,2022,2020,30,15,15,0.197,0.063,0.696,177.774,36,36,95380,97610,2649,2711,72095,74020,2002,2056,62,54
2012 - 2014,45059,45059,2014,2012,6,2,4,0.253,0.042,0.686,93.006,35,33,66625,66390,1903,2011,50060,50075,1430,1517,108,87
2014 - 2016,45059,45059,2016,2014,2,1,1,0.249,0.043,0.683,93.076,33,33,66390,66440,2011,2013,50075,50290,1517,1523,2,6
2016 - 2018,45059,45059,2018,2016,4,2,2,0.246,0.047,0.680,93.463,33,33,66440,66710,2013,2021,50290,50915,1523,1542,8,19
2018 - 2020,45059,45059,2020,2018,8,4,4,0.236,0.051,0.677,93.972,33,33,66710,66990,2021,2030,50915,51220,1542,1552,9,10
2020 - 2022,45059,45059,2022,2020,10,5,5,0.232,0.056,0.674,94.624,33,33,66990,67455,2030,2044,51220,51315,1552,1555,14,3
2012 - 2014,45061,45061,2014,2012,0,0,0,0.631,0.020,0.332,45.614,22,22,19160,18710,870,850,14565,14465,662,657,20,5
2014 - 2016,45061,45061,2016,2014,0,0,0,0.627,0.023,0.331,44.346,22,22,18710,18190,850,826,14465,14245,657,647,24,10
2016 - 2018,45061,45061,2018,2016,0,0,0,0.641,0.024,0.324,42.920,22,22,18190,17605,826,800,14245,13955,647,634,26,13
2018 - 2020,45061,45061,2020,2018,5,1,4,0.635,0.025,0.325,41.798,22,19,17605,17145,800,902,13955,13740,634,723,102,89
2020 - 2022,45061,45061,2022,2020,4,4,0,0.624,0.026,0.330,40.360,19,23,17145,16555,902,719,13740,13160,723,572,183,151
2012 - 2014,45063,45063,2014,2012,4,4,0,0.143,0.057,0.764,386.634,91,95,262425,270265,2883,2844,190030,197115,2088,2074,39,14
2014 - 2016,45063,45063,2016,2014,0,0,0,0.143,0.056,0.760,397.249,95,95,270265,277700,2844,2923,197115,204135,2074,2148,79,74
2016 - 2018,45063,45063,2018,2016,0,0,0,0.145,0.059,0.753,409.612,95,95,277700,286315,2923,3013,204135,211175,2148,2222,90,74
2018 - 2020,45063,45063,2020,2018,9,3,6,0.147,0.061,0.745,422.083,95,92,286315,295035,3013,3206,211175,218545,2222,2375,193,153
2020 - 2022,45063,45063,2022,2020,65,34,31,0.150,0.065,0.735,423.366,92,95,295035,295935,3206,3115,218545,220480,2375,2320,91,55
2012 - 2014,45065,45065,2014,2012,1,1,0,0.492,0.010,0.484,27.859,10,11,10140,10005,1014,909,8670,8665,867,787,105,80
2014 - 2016,45065,45065,2016,2014,0,0,0,0.481,0.012,0.489,27.302,11,11,10005,9805,909,891,8665,8530,787,775,18,12
2016 - 2018,45065,45065,2018,2016,0,0,0,0.469,0.007,0.500,26.745,11,11,9805,9605,891,873,8530,8370,775,760,18,15
2018 - 2020,45065,45065,2020,2018,10,5,5,0.441,0.012,0.516,26.458,11,11,9605,9495,873,863,8370,8325,760,756,10,4
2020 - 2022,45065,45065,2022,2020,3,2,1,0.438,0.006,0.534,26.779,11,12,9495,9610,863,800,8325,8550,756,712,63,44
2012 - 2014,45067,45067,2014,2012,0,0,0,0.557,0.026,0.396,66.244,16,16,33040,32410,2065,2025,24520,24265,1532,1516,40,16
2014 - 2016,45067,45067,2016,2014,0,0,0,0.566,0.026,0.391,65.355,16,16,32410,31975,2025,1998,24265,23915,1516,1494,27,22
2016 - 2018,45067,45067,2018,2016,0,0,0,0.566,0.028,0.387,64.506,16,16,31975,31560,1998,1972,23915,23795,1494,1487,26,7
2018 - 2020,45067,45067,2020,2018,0,0,0,0.567,0.029,0.383,63.255,16,16,31560,30955,1972,1934,23795,23515,1487,1469,38,18
2020 - 2022,45067,45067,2022,2020,2,1,1,0.563,0.033,0.381,59.689,16,16,30955,29210,1934,1825,23515,22300,1469,1393,109,76
2012 - 2014,45069,45069,2014,2012,0,0,0,0.510,0.030,0.401,58.987,15,15,28750,28295,1916,1886,22135,21895,1475,1459,30,16
2014 - 2016,45069,45069,2016,2014,0,0,0,0.506,0.033,0.393,57.746,15,15,28295,27700,1886,1846,21895,21490,1459,1432,40,27
2016 - 2018,45069,45069,2018,2016,0,0,0,0.506,0.033,0.392,56.536,15,15,27700,27130,1846,1808,21490,21155,1432,1410,38,22
2018 - 2020,45069,45069,2020,2018,1,1,0,0.501,0.033,0.390,54.962,15,16,27130,26375,1808,1648,21155,20840,1410,1302,160,108
2020 - 2022,45069,45069,2022,2020,2,1,1,0.499,0.034,0.389,55.400,16,16,26375,26585,1648,1661,20840,21080,1302,1317,13,15
2012 - 2014,45071,45071,2014,2012,0,0,0,0.303,0.073,0.604,59.670,29,29,37430,37595,1290,1296,27355,27750,943,956,6,13
2014 - 2016,45071,45071,2016,2014,0,0,0,0.307,0.073,0.601,59.916,29,29,37595,37750,1296,1301,27750,28055,956,967,5,11
2016 - 2018,45071,45071,2018,2016,2,1,1,0.315,0.073,0.601,60.425,29,29,37750,38070,1301,1312,28055,28335,967,977,11,10
2018 - 2020,45071,45071,2020,2018,11,6,5,0.311,0.077,0.601,60.813,29,30,38070,38330,1312,1277,28335,28625,977,954,35,23
2020 - 2022,45071,45071,2022,2020,0,0,0,0.301,0.081,0.604,60.161,30,30,38330,37920,1277,1264,28625,28495,954,949,13,5
2012 - 2014,45073,45073,2014,2012,2,1,1,0.075,0.047,0.856,119.200,26,26,74040,74655,2847,2871,57080,57990,2195,2230,24,35
2014 - 2016,45073,45073,2016,2014,0,0,0,0.073,0.049,0.852,120.349,26,26,74655,75375,2871,2899,57990,58730,2230,2258,28,28
2016 - 2018,45073,45073,2018,2016,1,0,1,0.070,0.053,0.846,122.429,26,25,75375,76695,2899,3067,58730,59900,2258,2396,168,138
2018 - 2020,45073,45073,2020,2018,7,4,3,0.071,0.055,0.844,124.993,25,26,76695,78315,3067,3012,59900,61500,2396,2365,55,31
2020 - 2022,45073,45073,2022,2020,6,3,3,0.067,0.058,0.841,125.725,26,26,78315,78775,3012,3029,61500,62065,2365,2387,17,22
2012 - 2014,45075,45075,2014,2012,0,0,0,0.621,0.020,0.337,82.509,44,44,92230,91260,2096,2074,69880,69455,1588,1578,22,10
2014 - 2016,45075,45075,2016,2014,2,1,1,0.618,0.020,0.335,81.126,44,44,91260,89730,2074,2039,69455,68330,1578,1552,35,26
2016 - 2018,45075,45075,2018,2016,0,0,0,0.614,0.022,0.333,79.953,44,44,89730,88455,2039,2010,68330,67775,1552,1540,29,12
2018 - 2020,45075,45075,2020,2018,1,1,0,0.614,0.023,0.333,78.594,44,45,88455,86955,2010,1932,67775,67380,1540,1497,78,43
2020 - 2022,45075,45075,2022,2020,32,17,15,0.614,0.025,0.332,76.068,45,47,86955,84160,1932,1790,67380,65480,1497,1393,142,104
2012 - 2014,45077,45077,2014,2012,6,3,3,0.065,0.033,0.868,240.909,54,54,119165,119575,2206,2214,92055,92485,1704,1712,8,8
2014 - 2016,45077,45077,2016,2014,12,6,6,0.065,0.034,0.865,243.216,54,54,119575,120720,2214,2235,92485,93845,1712,1737,21,25
2016 - 2018,45077,45077,2018,2016,14,7,7,0.066,0.036,0.860,247.014,54,54,120720,122745,2235,2273,93845,96235,1737,1782,38,45
2018 - 2020,45077,45077,2020,2018,19,9,10,0.065,0.038,0.856,252.304,54,53,122745,125380,2273,2365,96235,99210,1782,1871,92,89
2020 - 2022,45077,45077,2022,2020,52,27,25,0.062,0.042,0.851,263.825,53,55,125380,131105,2365,2383,99210,103955,1871,1890,18,19
2012 - 2014,45079,45079,2014,2012,29,26,3,0.456,0.049,0.447,519.989,121,144,384595,393705,3178,2734,285625,294035,2360,2041,444,319
2014 - 2016,45079,45079,2016,2014,1,0,1,0.460,0.050,0.439,530.598,144,143,393705,401745,2734,2809,294035,302815,2041,2117,75,76
2016 - 2018,45079,45079,2018,2016,14,6,8,0.463,0.051,0.430,539.093,143,141,401745,408265,2809,2895,302815,309105,2117,2192,86,75
2018 - 2020,45079,45079,2020,2018,25,12,13,0.471,0.053,0.420,547.566,141,140,408265,414660,2895,2961,309105,314265,2192,2244,66,52
2020 - 2022,45079,45079,2022,2020,69,31,38,0.473,0.054,0.411,549.526,140,133,414660,416160,2961,3129,314265,315795,2244,2374,168,130
2012 - 2014,45081,45081,2014,2012,0,0,0,0.261,0.146,0.582,44.117,14,14,19760,19975,1411,1426,13725,13750,980,982,15,2
2014 - 2016,45081,45081,2016,2014,0,0,0,0.254,0.149,0.582,44.426,14,14,19975,20115,1426,1436,13750,14055,982,1003,10,21
2016 - 2018,45081,45081,2018,2016,0,0,0,0.250,0.156,0.580,44.822,14,14,20115,20300,1436,1450,14055,14430,1003,1030,14,27
2018 - 2020,45081,45081,2020,2018,14,6,8,0.244,0.154,0.586,44.819,14,12,20300,20290,1450,1690,14430,14770,1030,1230,240,200
2020 - 2022,45081,45081,2022,2020,8,3,5,0.233,0.161,0.586,41.859,12,10,20290,18950,1690,1895,14770,13920,1230,1392,205,162
2012 - 2014,45083,45083,2014,2012,1,0,1,0.204,0.061,0.696,357.356,97,96,284540,288730,2933,3007,205065,209030,2114,2177,74,63
2014 - 2016,45083,45083,2016,2014,15,6,9,0.205,0.063,0.692,364.166,96,93,288730,294230,3007,3163,209030,214820,2177,2309,156,132
2016 - 2018,45083,45083,2018,2016,6,5,1,0.203,0.067,0.687,374.122,93,97,294230,302195,3163,3115,214820,222050,2309,2289,48,20
2018 - 2020,45083,45083,2020,2018,14,7,7,0.199,0.070,0.681,388.175,97,97,302195,313790,3115,3234,222050,230890,2289,2380,119,91
2020 - 2022,45083,45083,2022,2020,78,38,40,0.202,0.076,0.674,408.373,97,95,313790,330120,3234,3474,230890,242910,2380,2556,240,176
2012 - 2014,45085,45085,2014,2012,1,0,1,0.463,0.035,0.467,162.057,44,43,107280,107780,2438,2506,77860,78810,1769,1832,68,63
2014 - 2016,45085,45085,2016,2014,0,0,0,0.466,0.037,0.461,161.906,43,43,107780,107680,2506,2504,78810,79140,1832,1840,2,8
2016 - 2018,45085,45085,2018,2016,2,1,1,0.470,0.039,0.455,160.876,43,43,107680,106995,2504,2488,79140,79255,1840,1843,16,3
2018 - 2020,45085,45085,2020,2018,12,5,7,0.468,0.041,0.450,160.395,43,41,106995,106675,2488,2601,79255,79940,1843,1949,113,106
2020 - 2022,45085,45085,2022,2020,19,10,9,0.458,0.043,0.448,158.177,41,42,106675,105200,2601,2504,79940,79020,1949,1881,97,68
2012 - 2014,45087,45087,2014,2012,0,0,0,0.309,0.011,0.658,55.098,23,23,28805,28330,1252,1231,22150,21860,963,950,21,13
2014 - 2016,45087,45087,2016,2014,0,0,0,0.309,0.013,0.654,54.320,23,23,28330,27930,1231,1214,21860,21785,950,947,17,3
2016 - 2018,45087,45087,2018,2016,0,0,0,0.310,0.014,0.648,53.766,23,23,27930,27645,1214,1201,21785,21570,947,937,13,10
2018 - 2020,45087,45087,2020,2018,1,1,0,0.300,0.016,0.643,53.204,23,24,27645,27325,1201,1138,21570,21395,937,891,63,46
2020 - 2022,45087,45087,2022,2020,6,3,3,0.290,0.018,0.643,52.883,24,24,27325,27160,1138,1131,21395,21270,891,886,7,5
2012 - 2014,45089,45089,2014,2012,0,0,0,0.655,0.022,0.314,35.925,28,28,34360,33560,1227,1198,25990,25650,928,916,29,12
2014 - 2016,45089,45089,2016,2014,1,0,1,0.651,0.023,0.313,35.128,28,27,33560,32815,1198,1215,25650,25370,916,939,17,23
2016 - 2018,45089,45089,2018,2016,0,0,0,0.646,0.023,0.312,34.036,27,27,32815,31795,1215,1177,25370,24650,939,912,38,27
2018 - 2020,45089,45089,2020,2018,6,4,2,0.643,0.023,0.315,32.981,27,29,31795,30810,1177,1062,24650,24045,912,829,115,83
2020 - 2022,45089,45089,2022,2020,4,2,2,0.637,0.029,0.317,33.056,29,29,30810,30880,1062,1064,24045,23990,829,827,2,2
2012 - 2014,45091,45091,2014,2012,9,6,3,0.186,0.047,0.722,345.657,85,88,226575,235285,2665,2673,163000,170230,1917,1934,8,17
2014 - 2016,45091,45091,2016,2014,11,5,6,0.187,0.050,0.717,360.815,88,87,235285,245605,2673,2823,170230,179195,1934,2059,150,125
2016 - 2018,45091,45091,2018,2016,20,10,10,0.191,0.053,0.710,379.977,87,87,245605,258640,2823,2972,179195,189355,2059,2176,149,117
2018 - 2020,45091,45091,2020,2018,11,6,5,0.190,0.057,0.701,402.161,87,88,258640,273885,2972,3112,189355,199415,2176,2266,140,90
2020 - 2022,45091,45091,2022,2020,77,39,38,0.188,0.063,0.690,415.522,88,89,273885,282985,3112,3179,199415,207580,2266,2332,67,66
2012 - 2014,55001,55001,2014,2012,0,0,0,0.030,0.038,0.908,31.916,19,19,20900,20605,1100,1084,17120,17050,901,897,16,4
2014 - 2016,55001,55001,2016,2014,2,1,1,0.031,0.038,0.908,31.435,19,19,20605,20295,1084,1068,17050,17015,897,895,16,2
2016 - 2018,55001,55001,2018,2016,0,0,0,0.029,0.039,0.907,31.092,19,19,20295,20075,1068,1056,17015,16875,895,888,12,7
2018 - 2020,55001,55001,2020,2018,2,1,1,0.026,0.041,0.904,31.302,19,19,20075,20210,1056,1063,16875,17020,888,895,7,7
2020 - 2022,55001,55001,2022,2020,2,1,1,0.025,0.045,0.898,32.107,19,19,20210,20730,1063,1091,17020,17620,895,927,28,32
2012 - 2014,55003,55003,2014,2012,2,1,1,0.003,0.022,0.834,15.373,18,18,16115,16065,895,892,12320,12330,684,685,3,1
2014 - 2016,55003,55003,2016,2014,2,1,1,0.005,0.024,0.829,15.248,18,18,16065,15935,892,885,12330,12265,685,681,7,4
2016 - 2018,55003,55003,2018,2016,2,1,1,0.007,0.028,0.825,15.034,18,18,15935,15710,885,872,12265,12125,681,673,13,8
2018 - 2020,55003,55003,2020,2018,5,2,3,0.008,0.030,0.824,14.857,18,17,15710,15525,872,913,12125,12035,673,707,41,34
2020 - 2022,55003,55003,2022,2020,3,2,1,0.016,0.033,0.821,15.350,17,18,15525,16040,913,891,12035,12555,707,697,22,10
2012 - 2014,55005,55005,2014,2012,2,1,1,0.012,0.022,0.944,52.994,36,36,45880,45720,1274,1270,35315,35335,980,981,4,1
2014 - 2016,55005,55005,2016,2014,4,2,2,0.012,0.023,0.940,52.796,36,36,45720,45550,1270,1265,35335,35205,981,977,5,4
2016 - 2018,55005,55005,2018,2016,2,1,1,0.014,0.025,0.936,52.432,36,36,45550,45250,1265,1256,35205,35020,977,972,9,5
2018 - 2020,55005,55005,2020,2018,4,2,2,0.014,0.026,0.930,52.349,36,36,45250,45180,1256,1255,35020,34970,972,971,1,1
2020 - 2022,55005,55005,2022,2020,4,2,2,0.018,0.030,0.924,54.093,36,36,45180,46685,1255,1296,34970,36230,971,1006,41,35
2012 - 2014,55007,55007,2014,2012,4,2,2,0.006,0.013,0.857,10.194,28,28,15080,15065,538,538,12185,12195,435,435,0,0
2014 - 2016,55007,55007,2016,2014,2,1,1,0.006,0.016,0.852,10.140,28,28,15065,14985,538,535,12195,12210,435,436,3,1
2016 - 2018,55007,55007,2018,2016,2,1,1,0.008,0.019,0.849,10.143,28,28,14985,14990,535,535,12210,12245,436,437,0,1
2018 - 2020,55007,55007,2020,2018,0,0,0,0.003,0.022,0.846,10.211,28,28,14990,15090,535,538,12245,12415,437,443,3,6
2020 - 2022,55007,55007,2022,2020,3,1,2,0.008,0.024,0.847,10.972,28,27,15090,16215,538,600,12415,13435,443,497,62,54
2012 - 2014,55009,55009,2014,2012,3,1,2,0.021,0.077,0.829,477.020,76,75,248525,252700,3270,3369,179495,182465,2361,2432,99,71
2014 - 2016,55009,55009,2016,2014,10,5,5,0.021,0.081,0.822,484.422,75,75,252700,256620,3369,3421,182465,186115,2432,2481,52,49
2016 - 2018,55009,55009,2018,2016,13,3,10,0.023,0.084,0.814,490.075,75,68,256620,259785,3421,3820,186115,188265,2481,2768,399,287
2018 - 2020,55009,55009,2020,2018,36,10,26,0.025,0.090,0.804,495.310,68,52,259785,262560,3820,5049,188265,192065,2768,3693,1229,925
2020 - 2022,55009,55009,2022,2020,57,35,22,0.026,0.095,0.796,506.318,52,65,262560,268395,5049,4129,192065,197970,3693,3045,920,648
2012 - 2014,55011,55011,2014,2012,0,0,0,0.004,0.019,0.965,19.914,22,22,13545,13375,615,607,10485,10420,476,473,8,3
2014 - 2016,55011,55011,2016,2014,0,0,0,0.004,0.021,0.962,19.735,22,22,13375,13255,607,602,10420,10335,473,469,5,4
2016 - 2018,55011,55011,2018,2016,5,2,3,0.006,0.021,0.959,19.481,22,21,13255,13165,602,626,10335,10315,469,491,24,22
2018 - 2020,55011,55011,2020,2018,5,3,2,0.005,0.023,0.956,19.362,21,22,13165,13085,626,594,10315,10325,491,469,32,22
2020 - 2022,55011,55011,2022,2020,3,1,2,0.003,0.026,0.952,19.725,22,21,13085,13330,594,634,10325,10550,469,502,40,33
2012 - 2014,55013,55013,2014,2012,0,0,0,0.006,0.014,0.908,18.726,23,23,15530,15385,675,668,12455,12405,541,539,7,2
2014 - 2016,55013,55013,2016,2014,0,0,0,0.005,0.015,0.908,18.574,23,23,15385,15260,668,663,12405,12385,539,538,5,1
2016 - 2018,55013,55013,2018,2016,2,1,1,0.005,0.018,0.905,18.574,23,23,15260,15260,663,663,12385,12475,538,542,0,4
2018 - 2020,55013,55013,2020,2018,2,1,1,0.006,0.020,0.905,18.702,23,23,15260,15365,663,668,12475,12605,542,548,5,6
2020 - 2022,55013,55013,2022,2020,4,2,2,0.007,0.021,0.904,20.156,23,23,15365,16560,668,720,12605,13730,548,596,52,48
2012 - 2014,55015,55015,2014,2012,3,1,2,0.005,0.037,0.921,155.545,17,16,48960,49500,2880,3093,35295,36015,2076,2250,213,174
2014 - 2016,55015,55015,2016,2014,6,4,2,0.008,0.039,0.917,156.032,16,18,49500,49655,3093,2758,36015,36505,2250,2028,335,222
2016 - 2018,55015,55015,2018,2016,2,0,2,0.008,0.042,0.912,156.482,18,16,49655,49805,2758,3112,36505,37225,2028,2326,354,298
2018 - 2020,55015,55015,2020,2018,6,3,3,0.009,0.044,0.908,157.125,16,16,49805,50005,3112,3125,37225,37685,2326,2355,13,29
2020 - 2022,55015,55015,2022,2020,7,3,4,0.010,0.047,0.903,164.525,16,15,50005,52360,3125,3490,37685,39570,2355,2638,365,283
2012 - 2014,55017,55017,2014,2012,8,4,4,0.014,0.014,0.943,62.528,34,34,62360,63050,1834,1854,47450,48195,1395,1417,20,22
2014 - 2016,55017,55017,2016,2014,4,2,2,0.013,0.015,0.941,62.830,34,34,63050,63355,1854,1863,48195,48555,1417,1428,9,11
2016 - 2018,55017,55017,2018,2016,1,0,1,0.012,0.017,0.937,63.108,34,33,63355,63635,1863,1928,48555,48770,1428,1477,65,49
2018 - 2020,55017,55017,2020,2018,5,3,2,0.015,0.018,0.933,63.643,33,34,63635,64175,1928,1887,48770,49655,1477,1460,41,17
2020 - 2022,55017,55017,2022,2020,16,8,8,0.016,0.019,0.932,65.706,34,34,64175,66255,1887,1948,49655,51455,1460,1513,61,53
2012 - 2014,55019,55019,2014,2012,0,0,0,0.003,0.039,0.941,28.581,44,44,34610,34575,786,785,23955,23800,544,540,1,4
2014 - 2016,55019,55019,2016,2014,4,2,2,0.004,0.042,0.937,28.507,44,44,34575,34485,785,783,23800,23690,540,538,2,2
2016 - 2018,55019,55019,2018,2016,2,1,1,0.003,0.044,0.933,28.511,44,44,34485,34490,783,783,23690,23760,538,540,0,2
2018 - 2020,55019,55019,2020,2018,5,3,2,0.002,0.050,0.927,28.660,44,45,34490,34670,783,770,23760,23825,540,529,13,11
2020 - 2022,55019,55019,2022,2020,4,2,2,0.002,0.055,0.921,28.689,45,45,34670,34705,770,771,23825,23805,529,529,1,0
2012 - 2014,55021,55021,2014,2012,2,1,1,0.015,0.027,0.939,74.014,33,33,56595,56660,1715,1716,43070,43320,1305,1312,1,7
2014 - 2016,55021,55021,2016,2014,6,3,3,0.014,0.030,0.934,74.000,33,33,56660,56650,1716,1716,43320,43475,1312,1317,0,5
2016 - 2018,55021,55021,2018,2016,1,0,1,0.012,0.032,0.929,74.398,33,32,56650,56955,1716,1779,43475,43855,1317,1370,63,53
2018 - 2020,55021,55021,2020,2018,4,2,2,0.016,0.036,0.922,74.888,32,32,56955,57330,1779,1791,43855,44330,1370,1385,12,15
2020 - 2022,55021,55021,2022,2020,7,4,3,0.017,0.039,0.918,76.110,32,33,57330,58270,1791,1765,44330,45505,1385,1378,26,7
2012 - 2014,55023,55023,2014,2012,0,0,0,0.014,0.010,0.969,28.958,20,20,16675,16525,833,826,12940,12885,647,644,7,3
2014 - 2016,55023,55023,2016,2014,4,2,2,0.018,0.012,0.952,28.765,20,20,16525,16415,826,820,12885,12975,644,648,6,4
2016 - 2018,55023,55023,2018,2016,5,2,3,0.019,0.014,0.946,28.547,20,19,16415,16290,820,857,12975,12860,648,676,37,28
2018 - 2020,55023,55023,2020,2018,2,1,1,0.019,0.017,0.943,28.310,19,19,16290,16155,857,850,12860,12840,676,675,7,1
2020 - 2022,55023,55023,2022,2020,4,2,2,0.018,0.018,0.942,28.250,19,19,16155,16125,850,848,12840,12825,675,675,2,0
2012 - 2014,55025,55025,2014,2012,4,3,1,0.050,0.061,0.812,420.184,159,161,490380,502985,3084,3124,362740,372315,2281,2312,40,31
2014 - 2016,55025,55025,2016,2014,20,12,8,0.050,0.062,0.806,431.968,161,165,502985,516820,3124,3132,372315,383690,2312,2325,8,13
2016 - 2018,55025,55025,2018,2016,28,15,13,0.050,0.063,0.799,442.830,165,167,516820,529845,3132,3172,383690,394780,2325,2363,40,38
2018 - 2020,55025,55025,2020,2018,79,37,42,0.048,0.065,0.792,453.375,167,162,529845,542460,3172,3348,394780,407160,2363,2513,176,150
2020 - 2022,55025,55025,2022,2020,150,88,62,0.050,0.068,0.786,467.944,162,188,542460,559890,3348,2978,407160,423915,2513,2254,370,259
2012 - 2014,55027,55027,2014,2012,2,1,1,0.027,0.043,0.911,101.168,43,43,88740,88590,2063,2060,68220,68620,1586,1595,3,9
2014 - 2016,55027,55027,2016,2014,4,2,2,0.021,0.045,0.907,100.957,43,43,88590,88405,2060,2055,68620,68800,1595,1600,5,5
2016 - 2018,55027,55027,2018,2016,2,1,1,0.027,0.047,0.901,100.233,43,43,88405,87775,2055,2041,68800,68410,1600,1590,14,10
2018 - 2020,55027,55027,2020,2018,8,3,5,0.027,0.050,0.897,100.000,43,41,87775,87570,2041,2135,68410,69225,1590,1688,94,98
2020 - 2022,55027,55027,2022,2020,15,7,8,0.025,0.055,0.894,101.667,41,40,87570,89030,2135,2225,69225,70360,1688,1759,90,71
2012 - 2014,55029,55029,2014,2012,0,0,0,0.005,0.026,0.949,57.660,21,21,27870,27790,1327,1323,22560,22690,1074,1080,4,6
2014 - 2016,55029,55029,2016,2014,4,2,2,0.005,0.027,0.946,57.411,21,21,27790,27670,1323,1317,22690,22740,1080,1082,6,2
2016 - 2018,55029,55029,2018,2016,2,1,1,0.005,0.030,0.942,56.934,21,21,27670,27440,1317,1306,22740,22585,1082,1075,11,7
2018 - 2020,55029,55029,2020,2018,2,1,1,0.005,0.033,0.938,57.307,21,21,27440,27620,1306,1315,22585,22775,1075,1084,9,9
2020 - 2022,55029,55029,2022,2020,4,2,2,0.004,0.037,0.933,62.332,21,21,27620,30040,1315,1430,22775,24840,1084,1182,115,98
2012 - 2014,55031,55031,2014,2012,4,2,2,0.012,0.013,0.922,33.662,26,26,43965,43900,1690,1688,34325,34325,1320,1320,2,0
2014 - 2016,55031,55031,2016,2014,2,1,1,0.012,0.014,0.921,33.512,26,26,43900,43705,1688,1680,34325,34415,1320,1323,8,3
2016 - 2018,55031,55031,2018,2016,2,1,1,0.013,0.015,0.918,33.275,26,26,43705,43400,1680,1669,34415,34220,1323,1316,11,7
2018 - 2020,55031,55031,2020,2018,2,1,1,0.013,0.017,0.915,33.348,26,26,43400,43495,1669,1672,34220,34450,1316,1325,3,9
2020 - 2022,55031,55031,2022,2020,10,5,5,0.013,0.018,0.912,33.804,26,26,43495,44090,1672,1695,34450,35220,1325,1354,23,29
2012 - 2014,55033,55033,2014,2012,2,1,1,0.005,0.016,0.935,51.809,33,33,43790,44045,1326,1334,34340,34620,1040,1049,8,9
2014 - 2016,55033,55033,2016,2014,9,5,4,0.005,0.017,0.933,52.167,33,34,44045,44350,1334,1304,34620,34970,1049,1028,30,21
2016 - 2018,55033,55033,2018,2016,8,4,4,0.006,0.018,0.930,52.343,34,34,44350,44500,1304,1308,34970,34940,1028,1027,4,1
2018 - 2020,55033,55033,2020,2018,4,1,3,0.006,0.020,0.926,52.967,34,32,44500,45030,1308,1407,34940,35705,1027,1115,99,88
2020 - 2022,55033,55033,2022,2020,8,5,3,0.003,0.022,0.921,53.190,32,34,45030,45220,1407,1330,35705,36000,1115,1058,77,57
2012 - 2014,55035,55035,2014,2012,4,2,2,0.007,0.021,0.915,157.707,37,37,98950,100605,2674,2719,76780,78595,2075,2124,45,49
2014 - 2016,55035,55035,2016,2014,6,3,3,0.008,0.022,0.909,159.745,37,37,100605,101905,2719,2754,78595,79570,2124,2150,35,26
2016 - 2018,55035,55035,2018,2016,3,2,1,0.009,0.024,0.903,161.446,37,38,101905,102990,2754,2710,79570,80345,2150,2114,44,36
2018 - 2020,55035,55035,2020,2018,12,6,6,0.011,0.026,0.897,163.233,38,38,102990,104130,2710,2740,80345,81780,2114,2152,30,38
2020 - 2022,55035,55035,2022,2020,36,18,18,0.011,0.028,0.893,165.686,38,38,104130,105695,2740,2781,81780,83365,2152,2193,41,41
2012 - 2014,55037,55037,2014,2012,0,0,0,0.002,0.009,0.956,9.168,7,7,4485,4475,640,639,3615,3645,516,520,1,4
2014 - 2016,55037,55037,2016,2014,0,0,0,0.002,0.010,0.982,9.168,7,7,4475,4475,639,639,3645,3755,520,536,0,16
2016 - 2018,55037,55037,2018,2016,3,2,1,0.003,0.014,0.975,8.881,7,8,4475,4335,639,541,3755,3605,536,450,98,86
2018 - 2020,55037,55037,2020,2018,2,1,1,0.007,0.005,0.973,8.830,8,8,4335,4310,541,538,3605,3645,450,455,3,5
2020 - 2022,55037,55037,2022,2020,2,1,1,0.004,0.004,0.962,9.375,8,8,4310,4575,538,571,3645,3850,455,481,33,26
2012 - 2014,55039,55039,2014,2012,0,0,0,0.011,0.046,0.914,141.352,38,38,101575,101710,2673,2676,76750,77210,2019,2031,3,12
2014 - 2016,55039,55039,2016,2014,6,3,3,0.012,0.048,0.908,141.713,38,38,101710,101970,2676,2683,77210,77325,2031,2034,7,3
2016 - 2018,55039,55039,2018,2016,0,0,0,0.014,0.050,0.900,142.190,38,38,101970,102315,2683,2692,77325,78020,2034,2053,9,19
2018 - 2020,55039,55039,2020,2018,3,2,1,0.014,0.054,0.893,142.662,38,39,102315,102655,2692,2632,78020,78625,2053,2016,60,37
2020 - 2022,55039,55039,2022,2020,13,6,7,0.016,0.058,0.885,144.566,39,38,102655,104025,2632,2737,78625,80000,2016,2105,105,89
2012 - 2014,55041,55041,2014,2012,0,0,0,0.010,0.018,0.813,9.071,14,14,9360,9200,668,657,7250,7235,517,516,11,1
2014 - 2016,55041,55041,2016,2014,0,0,0,0.013,0.020,0.803,8.982,14,14,9200,9110,657,650,7235,7200,516,514,7,2
2016 - 2018,55041,55041,2018,2016,0,0,0,0.008,0.023,0.794,8.893,14,14,9110,9020,650,644,7200,7165,514,511,6,3
2018 - 2020,55041,55041,2020,2018,0,0,0,0.010,0.027,0.790,8.879,14,14,9020,9005,644,643,7165,7180,511,512,1,1
2020 - 2022,55041,55041,2022,2020,0,0,0,0.003,0.025,0.797,9.110,14,14,9005,9240,643,660,7180,7430,512,530,17,18
2012 - 2014,55043,55043,2014,2012,2,1,1,0.013,0.013,0.959,44.704,49,49,51055,51270,1041,1046,39930,40265,814,821,5,7
2014 - 2016,55043,55043,2016,2014,17,8,9,0.014,0.014,0.956,45.101,49,48,51270,51725,1046,1077,40265,40780,821,849,31,28
2016 - 2018,55043,55043,2018,2016,4,2,2,0.014,0.016,0.952,45.192,48,48,51725,51830,1077,1079,40780,40685,849,847,2,2
2018 - 2020,55043,55043,2020,2018,9,5,4,0.015,0.018,0.949,44.966,48,49,51830,51570,1079,1052,40685,40415,847,824,27,23
2020 - 2022,55043,55043,2022,2020,8,4,4,0.016,0.020,0.946,45.201,49,49,51570,51840,1052,1057,40415,40585,824,828,5,4
2012 - 2014,55045,55045,2014,2012,0,0,0,0.003,0.029,0.950,63.300,22,22,36800,36970,1672,1680,27500,27780,1250,1262,8,12
2014 - 2016,55045,55045,2016,2014,5,2,3,0.004,0.030,0.947,63.437,22,21,36970,37050,1680,1764,27780,28010,1262,1333,84,71
2016 - 2018,55045,55045,2018,2016,0,0,0,0.004,0.030,0.945,63.120,21,21,37050,36865,1764,1755,28010,28130,1333,1339,9,6
2018 - 2020,55045,55045,2020,2018,9,4,5,0.006,0.032,0.943,62.992,21,20,36865,36790,1755,1839,28130,28215,1339,1410,84,71
2020 - 2022,55045,55045,2022,2020,8,4,4,0.006,0.034,0.939,63.463,20,20,36790,37065,1839,1853,28215,28655,1410,1432,14,22
2012 - 2014,55047,55047,2014,2012,0,0,0,0.005,0.043,0.937,54.389,15,15,19065,19000,1271,1266,14500,14290,966,952,5,14
2014 - 2016,55047,55047,2016,2014,1,0,1,0.006,0.046,0.931,54.046,15,14,19000,18880,1266,1348,14290,14160,952,1011,82,59
2016 - 2018,55047,55047,2018,2016,6,3,3,0.009,0.048,0.926,53.656,14,14,18880,18755,1348,1339,14160,14135,1011,1009,9,2
2018 - 2020,55047,55047,2020,2018,2,1,1,0.009,0.051,0.921,53.799,14,14,18755,18805,1339,1343,14135,14460,1009,1032,4,23
2020 - 2022,55047,55047,2022,2020,1,1,0,0.009,0.054,0.915,54.628,14,15,18805,19095,1343,1273,14460,14780,1032,985,70,47
2012 - 2014,55049,55049,2014,2012,4,2,2,0.003,0.016,0.963,31.146,24,24,23710,23755,987,989,17720,17940,738,747,2,9
2014 - 2016,55049,55049,2016,2014,2,1,1,0.005,0.017,0.961,31.139,24,24,23755,23750,989,989,17940,18040,747,751,0,4
2016 - 2018,55049,55049,2018,2016,1,0,1,0.008,0.017,0.956,30.969,24,23,23750,23620,989,1026,18040,17960,751,780,37,29
2018 - 2020,55049,55049,2020,2018,3,2,1,0.008,0.019,0.951,30.982,23,24,23620,23630,1026,984,17960,18125,780,755,42,25
2020 - 2022,55049,55049,2022,2020,6,3,3,0.009,0.021,0.947,31.159,24,24,23630,23765,984,990,18125,18405,755,766,6,11
2012 - 2014,55051,55051,2014,2012,2,1,1,0.007,0.008,0.970,7.815,12,12,5980,5925,498,493,4945,4960,412,413,5,1
2014 - 2016,55051,55051,2016,2014,2,1,1,0.007,0.010,0.962,7.716,12,12,5925,5850,493,487,4960,4955,413,412,6,1
2016 - 2018,55051,55051,2018,2016,0,0,0,0.008,0.013,0.957,7.538,12,12,5850,5715,487,476,4955,4885,412,407,11,5
2018 - 2020,55051,55051,2020,2018,0,0,0,0.002,0.013,0.953,7.491,12,12,5715,5680,476,473,4885,4820,407,401,3,6
2020 - 2022,55051,55051,2022,2020,0,0,0,0.001,0.015,0.949,8.091,12,12,5680,6135,473,511,4820,5195,401,432,38,31
2012 - 2014,55053,55053,2014,2012,2,1,1,0.022,0.029,0.871,20.800,24,24,20435,20545,851,856,15645,15880,651,661,5,10
2014 - 2016,55053,55053,2016,2014,0,0,0,0.020,0.031,0.867,20.820,24,24,20545,20565,856,856,15880,15835,661,659,0,2
2016 - 2018,55053,55053,2018,2016,3,1,2,0.021,0.033,0.864,20.771,24,23,20565,20505,856,891,15835,15745,659,684,35,25
2018 - 2020,55053,55053,2020,2018,3,1,2,0.020,0.036,0.861,20.806,23,22,20505,20555,891,934,15745,15820,684,719,43,35
2020 - 2022,55053,55053,2022,2020,3,2,1,0.018,0.037,0.860,21.216,22,23,20555,20960,934,911,15820,16230,719,705,23,14
2012 - 2014,55055,55055,2014,2012,0,0,0,0.007,0.068,0.904,151.313,25,25,83750,84200,3350,3368,61790,63035,2471,2521,18,50
2014 - 2016,55055,55055,2016,2014,3,1,2,0.008,0.069,0.901,151.924,25,24,84200,84540,3368,3522,63035,63745,2521,2656,154,135
2016 - 2018,55055,55055,2018,2016,4,2,2,0.008,0.070,0.898,152.121,24,24,84540,84650,3522,3527,63745,64560,2656,2690,5,34
2018 - 2020,55055,55055,2020,2018,3,2,1,0.007,0.072,0.895,152.446,24,25,84650,84835,3527,3393,64560,65435,2690,2617,134,73
2020 - 2022,55055,55055,2022,2020,10,5,5,0.009,0.075,0.890,154.414,25,25,84835,85930,3393,3437,65435,66860,2617,2674,44,57
2012 - 2014,55057,55057,2014,2012,0,0,0,0.021,0.028,0.923,34.685,26,26,26700,26605,1026,1023,20695,20915,795,804,3,9
2014 - 2016,55057,55057,2016,2014,4,2,2,0.023,0.030,0.920,34.418,26,26,26605,26400,1023,1015,20915,20805,804,800,8,4
2016 - 2018,55057,55057,2018,2016,2,1,1,0.023,0.030,0.918,34.444,26,26,26400,26420,1015,1016,20805,20890,800,803,1,3
2018 - 2020,55057,55057,2020,2018,6,3,3,0.023,0.032,0.916,34.683,26,26,26420,26605,1016,1023,20890,21040,803,809,7,6
2020 - 2022,55057,55057,2022,2020,0,0,0,0.025,0.033,0.911,34.801,26,26,26605,26695,1023,1026,21040,21210,809,815,3,6
2012 - 2014,55059,55059,2014,2012,4,2,2,0.069,0.122,0.774,614.947,42,42,166375,167270,3961,3982,118005,120745,2809,2874,21,65
2014 - 2016,55059,55059,2016,2014,7,3,4,0.071,0.126,0.768,617.224,42,41,167270,167895,3982,4095,120745,122575,2874,2989,113,115
2016 - 2018,55059,55059,2018,2016,17,7,10,0.071,0.129,0.762,619.182,41,38,167895,168330,4095,4429,122575,123950,2989,3261,334,272
2018 - 2020,55059,55059,2020,2018,15,1,14,0.067,0.135,0.754,621.696,38,25,168330,169000,4429,6760,123950,124305,3261,4972,2331,1711
2020 - 2022,55059,55059,2022,2020,31,19,12,0.065,0.140,0.747,620.583,25,32,169000,168695,6760,5271,124305,125575,4972,3924,1489,1048
2012 - 2014,55061,55061,2014,2012,2,1,1,0.004,0.023,0.956,59.999,12,12,20600,20545,1716,1712,15545,15665,1295,1305,4,10
2014 - 2016,55061,55061,2016,2014,0,0,0,0.004,0.025,0.953,59.751,12,12,20545,20460,1712,1705,15665,15720,1305,1310,7,5
2016 - 2018,55061,55061,2018,2016,0,0,0,0.004,0.028,0.948,59.453,12,12,20460,20360,1705,1696,15720,15630,1310,1302,9,8
2018 - 2020,55061,55061,2020,2018,2,1,1,0.007,0.032,0.942,59.570,12,12,20360,20400,1696,1700,15630,15785,1302,1315,4,13
2020 - 2022,55061,55061,2022,2020,0,0,0,0.005,0.034,0.940,60.066,12,12,20400,20570,1700,1714,15785,16030,1315,1335,14,20
2012 - 2014,55063,55063,2014,2012,6,3,3,0.014,0.016,0.907,257.819,32,32,114720,116470,3585,3639,88705,90970,2772,2842,54,70
2014 - 2016,55063,55063,2016,2014,10,4,6,0.012,0.017,0.906,260.187,32,30,116470,117540,3639,3918,90970,92480,2842,3082,279,240
2016 - 2018,55063,55063,2018,2016,4,2,2,0.014,0.018,0.901,260.863,30,30,117540,117850,3918,3928,92480,93330,3082,3111,10,29
2018 - 2020,55063,55063,2020,2018,8,4,4,0.016,0.020,0.896,261.552,30,30,117850,118170,3928,3939,93330,93825,3111,3127,11,16
2020 - 2022,55063,55063,2022,2020,26,13,13,0.017,0.022,0.891,266.076,30,30,118170,120215,3939,4007,93825,95830,3127,3194,68,67
2012 - 2014,55065,55065,2014,2012,0,0,0,0.003,0.034,0.951,26.587,25,25,16835,16845,673,673,12265,12370,490,494,0,4
2014 - 2016,55065,55065,2016,2014,4,2,2,0.003,0.035,0.948,26.508,25,25,16845,16795,673,671,12370,12390,494,495,2,1
2016 - 2018,55065,55065,2018,2016,2,1,1,0.006,0.037,0.944,26.413,25,25,16795,16735,671,669,12390,12340,495,493,2,2
2018 - 2020,55065,55065,2020,2018,5,2,3,0.006,0.041,0.940,26.326,25,24,16735,16680,669,695,12340,12335,493,513,26,20
2020 - 2022,55065,55065,2022,2020,0,0,0,0.005,0.044,0.936,26.381,24,24,16680,16715,695,696,12335,12410,513,517,1,4
2012 - 2014,55067,55067,2014,2012,0,0,0,0.006,0.019,0.951,22.633,19,19,19950,19705,1050,1037,15545,15445,818,812,13,6
2014 - 2016,55067,55067,2016,2014,0,0,0,0.009,0.019,0.947,22.299,19,19,19705,19415,1037,1021,15445,15435,812,812,16,0
2016 - 2018,55067,55067,2018,2016,0,0,0,0.008,0.019,0.942,22.011,19,19,19415,19165,1021,1008,15435,15235,812,801,13,11
2018 - 2020,55067,55067,2020,2018,0,0,0,0.007,0.022,0.937,22.011,19,19,19165,19165,1008,1008,15235,15275,801,803,0,2
2020 - 2022,55067,55067,2022,2020,2,1,1,0.004,0.023,0.933,22.407,19,19,19165,19510,1008,1026,15275,15630,803,822,18,19
2012 - 2014,55069,55069,2014,2012,2,1,1,0.008,0.013,0.960,32.502,20,20,28710,28565,1435,1428,22400,22475,1120,1123,7,3
2014 - 2016,55069,55069,2016,2014,0,0,0,0.007,0.014,0.958,32.055,20,20,28565,28170,1428,1408,22475,22525,1123,1126,20,3
2016 - 2018,55069,55069,2018,2016,0,0,0,0.006,0.015,0.956,31.694,20,20,28170,27850,1408,1392,22525,22445,1126,1122,16,4
2018 - 2020,55069,55069,2020,2018,4,2,2,0.007,0.019,0.950,31.507,20,20,27850,27685,1392,1384,22445,22445,1122,1122,8,0
2020 - 2022,55069,55069,2022,2020,0,0,0,0.006,0.020,0.949,32.320,20,20,27685,28400,1384,1420,22445,23195,1122,1159,36,37
2012 - 2014,55071,55071,2014,2012,0,0,0,0.005,0.033,0.920,137.118,41,41,81265,80805,1982,1970,62385,62490,1521,1524,12,3
2014 - 2016,55071,55071,2016,2014,4,2,2,0.005,0.036,0.916,136.047,41,41,80805,80180,1970,1955,62490,62230,1524,1517,15,7
2016 - 2018,55071,55071,2018,2016,6,3,3,0.009,0.038,0.909,134.744,41,41,80180,79405,1955,1936,62230,61795,1517,1507,19,10
2018 - 2020,55071,55071,2020,2018,9,4,5,0.011,0.043,0.901,134.014,41,40,79405,78975,1936,1974,61795,61640,1507,1541,38,34
2020 - 2022,55071,55071,2022,2020,22,10,12,0.010,0.047,0.894,137.858,40,38,78975,81240,1974,2137,61640,63285,1541,1665,163,124
2012 - 2014,55073,55073,2014,2012,7,3,4,0.007,0.024,0.898,87.304,61,60,134040,134885,2197,2248,98645,100530,1617,1675,51,58
2014 - 2016,55073,55073,2016,2014,7,4,3,0.006,0.026,0.894,87.615,60,61,134885,135365,2248,2219,100530,101680,1675,1666,29,9
2016 - 2018,55073,55073,2018,2016,51,25,26,0.006,0.027,0.890,87.535,61,60,135365,135265,2219,2254,101680,102095,1666,1701,35,35
2018 - 2020,55073,55073,2020,2018,43,21,22,0.005,0.029,0.883,87.682,60,59,135265,135485,2254,2296,102095,102565,1701,1738,42,37
2020 - 2022,55073,55073,2022,2020,1,1,0,0.005,0.031,0.878,89.193,59,60,135485,137820,2296,2297,102565,104500,1738,1741,1,3
2012 - 2014,55075,55075,2014,2012,0,0,0,0.003,0.014,0.960,29.649,24,24,41705,41490,1737,1728,32980,32990,1374,1374,9,0
2014 - 2016,55075,55075,2016,2014,2,1,1,0.004,0.015,0.958,29.363,24,24,41490,41090,1728,1712,32990,32895,1374,1370,16,4
2016 - 2018,55075,55075,2018,2016,4,1,3,0.007,0.017,0.954,28.965,24,22,41090,40535,1712,1842,32895,32505,1370,1477,130,107
2018 - 2020,55075,55075,2020,2018,3,2,1,0.007,0.019,0.952,28.804,22,23,40535,40310,1842,1752,32505,32470,1477,1411,90,66
2020 - 2022,55075,55075,2022,2020,6,3,3,0.005,0.022,0.948,29.886,23,23,40310,41825,1752,1818,32470,33665,1411,1463,66,52
2012 - 2014,55077,55077,2014,2012,0,0,0,0.005,0.028,0.948,33.410,18,18,15365,15225,853,845,12180,12075,676,670,8,6
2014 - 2016,55077,55077,2016,2014,0,0,0,0.005,0.030,0.942,33.091,18,18,15225,15080,845,837,12075,11950,670,663,8,7
2016 - 2018,55077,55077,2018,2016,0,0,0,0.007,0.033,0.937,33.366,18,18,15080,15205,837,844,11950,12060,663,670,7,7
2018 - 2020,55077,55077,2020,2018,2,1,1,0.007,0.035,0.933,33.749,18,18,15205,15380,844,854,12060,12320,670,684,10,14
2020 - 2022,55077,55077,2022,2020,2,1,1,0.006,0.038,0.931,34.276,18,18,15380,15620,854,867,12320,12545,684,696,13,12
2012 - 2014,55078,55078,2014,2012,0,0,0,0.003,0.053,0.122,12.248,2,2,4275,4380,2137,2190,2900,3005,1450,1502,53,52
2014 - 2016,55078,55078,2016,2014,0,0,0,0.003,0.057,0.091,12.458,2,2,4380,4455,2190,2227,3005,2945,1502,1472,37,30
2016 - 2018,55078,55078,2018,2016,0,0,0,0.004,0.057,0.097,12.807,2,2,4455,4580,2227,2290,2945,3075,1472,1537,63,65
2018 - 2020,55078,55078,2020,2018,2,1,1,0.002,0.072,0.096,12.765,2,2,4580,4565,2290,2282,3075,3070,1537,1535,8,2
2020 - 2022,55078,55078,2022,2020,0,0,0,0.002,0.084,0.110,11.968,2,2,4565,4280,2282,2140,3070,2895,1535,1447,142,88
2012 - 2014,55079,55079,2014,2012,19,9,10,0.261,0.138,0.536,3948.033,272,271,946585,953400,3480,3518,664490,673690,2442,2485,38,43
2014 - 2016,55079,55079,2016,2014,23,11,12,0.262,0.143,0.527,3953.680,271,270,953400,955305,3518,3538,673690,676445,2485,2505,20,20
2016 - 2018,55079,55079,2018,2016,30,13,17,0.262,0.147,0.519,3951.443,270,266,955305,954210,3538,3587,676445,677440,2505,2546,49,41
2018 - 2020,55079,55079,2020,2018,64,12,52,0.260,0.154,0.507,3930.646,266,226,954210,949180,3587,4199,677440,676710,2546,2994,612,448
2020 - 2022,55079,55079,2022,2020,198,105,93,0.258,0.161,0.498,3864.304,226,238,949180,933065,4199,3920,676710,667205,2994,2803,279,191
2012 - 2014,55081,55081,2014,2012,0,0,0,0.012,0.039,0.919,50.077,36,36,44715,45115,1242,1253,32390,32920,899,914,11,15
2014 - 2016,55081,55081,2016,2014,4,2,2,0.012,0.040,0.915,50.355,36,36,45115,45365,1253,1260,32920,33300,914,925,7,11
2016 - 2018,55081,55081,2018,2016,14,6,8,0.016,0.044,0.909,50.505,36,34,45365,45500,1260,1338,33300,33425,925,983,78,58
2018 - 2020,55081,55081,2020,2018,2,1,1,0.018,0.048,0.903,51.232,34,34,45500,46155,1338,1357,33425,33985,983,999,19,16
2020 - 2022,55081,55081,2022,2020,8,4,4,0.015,0.051,0.897,51.293,34,34,46155,46210,1357,1359,33985,34010,999,1000,2,1
2012 - 2014,55083,55083,2014,2012,2,1,1,0.002,0.016,0.957,37.561,28,28,37630,37485,1343,1338,29130,29400,1040,1050,5,10
2014 - 2016,55083,55083,2016,2014,0,0,0,0.002,0.017,0.954,37.580,28,28,37485,37475,1338,1338,29400,29440,1050,1051,0,1
2016 - 2018,55083,55083,2018,2016,0,0,0,0.004,0.017,0.951,37.650,28,28,37475,37555,1338,1341,29440,29670,1051,1059,3,8
2018 - 2020,55083,55083,2020,2018,2,1,1,0.003,0.020,0.947,37.966,28,28,37555,37870,1341,1352,29670,30145,1059,1076,11,17
2020 - 2022,55083,55083,2022,2020,0,0,0,0.002,0.021,0.944,39.149,28,28,37870,39050,1352,1394,30145,31190,1076,1113,42,37
2012 - 2014,55085,55085,2014,2012,0,0,0,0.006,0.013,0.957,32.111,23,23,36030,35755,1566,1554,29240,29230,1271,1270,12,1
2014 - 2016,55085,55085,2016,2014,2,1,1,0.006,0.014,0.954,31.963,23,23,35755,35605,1554,1548,29230,29275,1270,1272,6,2
2016 - 2018,55085,55085,2018,2016,6,3,3,0.008,0.015,0.950,31.730,23,23,35605,35345,1548,1536,29275,29100,1272,1265,12,7
2018 - 2020,55085,55085,2020,2018,5,2,3,0.008,0.016,0.948,31.851,23,22,35345,35480,1536,1612,29100,29190,1265,1326,76,61
2020 - 2022,55085,55085,2022,2020,4,2,2,0.008,0.017,0.947,33.933,22,22,35480,37800,1612,1718,29190,31125,1326,1414,106,88
2012 - 2014,55087,55087,2014,2012,2,1,1,0.011,0.038,0.890,280.979,50,50,176775,179140,3535,3582,128675,131430,2573,2628,47,55
2014 - 2016,55087,55087,2016,2014,11,5,6,0.012,0.040,0.886,285.151,50,49,179140,181800,3582,3710,131430,134525,2628,2745,128,117
2016 - 2018,55087,55087,2018,2016,11,6,5,0.013,0.042,0.879,289.776,49,50,181800,184755,3710,3695,134525,137355,2745,2747,15,2
2018 - 2020,55087,55087,2020,2018,6,3,3,0.014,0.044,0.873,293.040,50,50,184755,186830,3695,3736,137355,139975,2747,2799,41,52
2020 - 2022,55087,55087,2022,2020,28,14,14,0.014,0.047,0.867,298.969,50,50,186830,190610,3736,3812,139975,143440,2799,2868,76,69
2012 - 2014,55089,55089,2014,2012,11,6,5,0.013,0.025,0.929,373.000,21,22,86430,86930,4115,3951,65350,66105,3111,3004,164,107
2014 - 2016,55089,55089,2016,2014,4,2,2,0.013,0.027,0.923,375.979,22,22,86930,87625,3951,3982,66105,66785,3004,3035,31,31
2016 - 2018,55089,55089,2018,2016,8,4,4,0.013,0.029,0.917,378.878,22,22,87625,88285,3982,4012,66785,67600,3035,3072,30,37
2018 - 2020,55089,55089,2020,2018,8,4,4,0.014,0.031,0.911,382.717,22,22,88285,89180,4012,4053,67600,68805,3072,3127,41,55
2020 - 2022,55089,55089,2022,2020,18,9,9,0.014,0.034,0.906,393.737,22,22,89180,91745,4053,4170,68805,71230,3127,3237,117,110
2012 - 2014,55091,55091,2014,2012,2,1,1,0.004,0.012,0.973,31.855,9,9,7460,7390,828,821,5720,5700,635,633,7,2
2014 - 2016,55091,55091,2016,2014,2,1,1,0.003,0.016,0.969,31.682,9,9,7390,7350,821,816,5700,5675,633,630,5,3
2016 - 2018,55091,55091,2018,2016,0,0,0,0.004,0.017,0.966,31.292,9,9,7350,7260,816,806,5675,5665,630,629,10,1
2018 - 2020,55091,55091,2020,2018,0,0,0,0.003,0.021,0.962,31.292,9,9,7260,7260,806,806,5665,5695,629,632,0,3
2020 - 2022,55091,55091,2022,2020,0,0,0,0.003,0.023,0.958,31.745,9,9,7260,7365,806,818,5695,5680,632,631,12,1
2012 - 2014,55093,55093,2014,2012,2,1,1,0.006,0.017,0.953,71.216,29,29,40840,40860,1408,1408,31525,31640,1087,1091,0,4
2014 - 2016,55093,55093,2016,2014,8,4,4,0.005,0.019,0.950,71.251,29,29,40860,40880,1408,1409,31640,31870,1091,1098,1,7
2016 - 2018,55093,55093,2018,2016,5,2,3,0.004,0.020,0.945,72.501,29,28,40880,41605,1409,1485,31870,32480,1098,1160,76,62
2018 - 2020,55093,55093,2020,2018,9,5,4,0.007,0.023,0.938,73.752,28,29,41605,42335,1485,1459,32480,33130,1160,1142,26,18
2020 - 2022,55093,55093,2022,2020,6,3,3,0.005,0.025,0.934,73.491,29,29,42335,42185,1459,1454,33130,33205,1142,1145,5,3
2012 - 2014,55095,55095,2014,2012,2,1,1,0.004,0.016,0.957,47.814,34,34,44095,43700,1296,1285,33415,33500,982,985,11,3
2014 - 2016,55095,55095,2016,2014,4,2,2,0.004,0.018,0.954,47.573,34,34,43700,43485,1285,1278,33500,33645,985,989,7,4
2016 - 2018,55095,55095,2018,2016,4,2,2,0.004,0.019,0.952,47.425,34,34,43485,43350,1278,1275,33645,33860,989,995,3,6
2018 - 2020,55095,55095,2020,2018,10,5,5,0.004,0.019,0.950,47.631,34,34,43350,43550,1275,1280,33860,34245,995,1007,5,12
2020 - 2022,55095,55095,2022,2020,8,4,4,0.004,0.020,0.949,49.359,34,34,43550,45130,1280,1327,34245,35765,1007,1051,47,44
2012 - 2014,55097,55097,2014,2012,12,6,6,0.006,0.028,0.923,87.829,37,37,70025,70335,1892,1900,54495,55145,1472,1490,8,18
2014 - 2016,55097,55097,2016,2014,8,4,4,0.007,0.029,0.919,88.098,37,37,70335,70550,1900,1906,55145,55610,1490,1502,6,12
2016 - 2018,55097,55097,2018,2016,5,2,3,0.007,0.032,0.914,88.153,37,36,70550,70600,1906,1961,55610,55280,1502,1535,55,33
2018 - 2020,55097,55097,2020,2018,6,3,3,0.007,0.034,0.909,88.428,36,36,70600,70820,1961,1967,55280,55895,1535,1552,6,17
2020 - 2022,55097,55097,2022,2020,3,1,2,0.009,0.036,0.905,87.754,36,35,70820,70280,1967,2008,55895,55920,1552,1597,41,45
2012 - 2014,55099,55099,2014,2012,0,0,0,0.001,0.014,0.959,11.076,20,20,14140,13890,707,694,11400,11280,570,564,13,6
2014 - 2016,55099,55099,2016,2014,2,1,1,0.005,0.015,0.953,10.929,20,20,13890,13705,694,685,11280,11265,564,563,9,1
2016 - 2018,55099,55099,2018,2016,1,0,1,0.007,0.018,0.944,10.757,20,19,13705,13490,685,710,11265,10990,563,578,25,15
2018 - 2020,55099,55099,2020,2018,2,1,1,0.006,0.019,0.940,10.645,19,19,13490,13350,710,702,10990,10940,578,575,8,3
2020 - 2022,55099,55099,2022,2020,0,0,0,0.002,0.021,0.939,11.216,19,19,13350,14065,702,740,10940,11430,575,601,38,26
2012 - 2014,55101,55101,2014,2012,7,3,4,0.108,0.120,0.738,586.524,45,44,195025,195040,4333,4432,141575,142345,3146,3235,99,89
2014 - 2016,55101,55101,2016,2014,4,2,2,0.108,0.125,0.732,586.024,44,44,195040,194875,4432,4428,142345,143185,3235,3254,4,19
2016 - 2018,55101,55101,2018,2016,5,2,3,0.109,0.129,0.724,587.514,44,43,194875,195400,4428,4544,143185,144850,3254,3368,116,114
2018 - 2020,55101,55101,2020,2018,21,8,13,0.112,0.137,0.713,588.802,43,38,195400,195860,4544,5154,144850,145800,3368,3836,610,468
2020 - 2022,55101,55101,2022,2020,33,17,16,0.108,0.145,0.705,592.440,38,39,195860,197070,5154,5053,145800,146455,3836,3755,101,81
2012 - 2014,55103,55103,2014,2012,4,2,2,0.004,0.022,0.956,30.436,21,21,18020,17840,858,849,13645,13625,649,648,9,1
2014 - 2016,55103,55103,2016,2014,2,1,1,0.007,0.022,0.954,30.095,21,21,17840,17640,849,840,13625,13520,648,643,9,5
2016 - 2018,55103,55103,2018,2016,2,1,1,0.005,0.023,0.951,29.924,21,21,17640,17540,840,835,13520,13455,643,640,5,3
2018 - 2020,55103,55103,2020,2018,2,0,2,0.006,0.025,0.946,29.702,21,19,17540,17410,835,916,13455,13415,640,706,81,66
2020 - 2022,55103,55103,2022,2020,2,2,0,0.007,0.028,0.941,29.438,19,21,17410,17255,916,821,13415,13395,706,637,95,69
2012 - 2014,55105,55105,2014,2012,6,3,3,0.035,0.079,0.841,223.456,47,47,160355,160465,3411,3414,116400,117095,2476,2491,3,15
2014 - 2016,55105,55105,2016,2014,22,11,11,0.034,0.082,0.837,224.169,47,47,160465,160985,3414,3425,117095,118245,2491,2515,11,24
2016 - 2018,55105,55105,2018,2016,10,5,5,0.043,0.085,0.831,225.264,47,47,160985,161770,3425,3441,118245,119635,2515,2545,16,30
2018 - 2020,55105,55105,2020,2018,17,4,13,0.046,0.090,0.822,226.312,47,38,161770,162530,3441,4277,119635,121035,2545,3185,836,640
2020 - 2022,55105,55105,2022,2020,19,14,5,0.047,0.095,0.817,228.101,38,47,162530,163815,4277,3485,121035,122460,3185,2605,792,580
2012 - 2014,55107,55107,2014,2012,1,0,1,0.007,0.014,0.963,15.838,26,25,14670,14470,564,578,11380,11295,437,451,14,14
2014 - 2016,55107,55107,2016,2014,3,2,1,0.010,0.016,0.956,15.620,25,26,14470,14270,578,548,11295,11105,451,427,30,24
2016 - 2018,55107,55107,2018,2016,2,1,1,0.010,0.018,0.949,15.527,26,26,14270,14185,548,545,11105,11195,427,430,3,3
2018 - 2020,55107,55107,2020,2018,0,0,0,0.006,0.020,0.948,15.407,26,26,14185,14075,545,541,11195,11140,430,428,4,2
2020 - 2022,55107,55107,2022,2020,4,3,1,0.007,0.021,0.947,15.522,26,28,14075,14180,541,506,11140,11270,428,402,35,26
2012 - 2014,55109,55109,2014,2012,2,1,1,0.007,0.021,0.946,118.261,36,36,84365,85440,2343,2373,60930,62285,1692,1730,30,38
2014 - 2016,55109,55109,2016,2014,3,1,2,0.008,0.022,0.944,120.038,36,35,85440,86725,2373,2477,62285,63580,1730,1816,104,86
2016 - 2018,55109,55109,2018,2016,0,0,0,0.008,0.023,0.941,121.691,35,35,86725,87915,2477,2511,63580,64830,1816,1852,34,36
2018 - 2020,55109,55109,2020,2018,6,3,3,0.007,0.025,0.938,124.211,35,35,87915,89700,2511,2562,64830,66665,1852,1904,51,52
2020 - 2022,55109,55109,2022,2020,8,4,4,0.007,0.026,0.935,129.819,35,35,89700,93750,2562,2678,66665,70275,1904,2007,116,103
2012 - 2014,55111,55111,2014,2012,7,2,5,0.005,0.046,0.920,75.437,38,35,61955,62680,1630,1790,46050,46810,1211,1337,160,126
2014 - 2016,55111,55111,2016,2014,3,2,1,0.006,0.048,0.916,76.143,35,36,62680,63315,1790,1758,46810,47845,1337,1329,32,8
2016 - 2018,55111,55111,2018,2016,6,3,3,0.008,0.049,0.913,76.478,36,36,63315,63595,1758,1766,47845,48000,1329,1333,8,4
2018 - 2020,55111,55111,2020,2018,1,1,0,0.007,0.053,0.907,77.146,36,37,63595,64150,1766,1733,48000,48230,1333,1303,33,30
2020 - 2022,55111,55111,2022,2020,5,2,3,0.008,0.058,0.902,78.968,37,36,64150,65665,1733,1824,48230,49770,1303,1382,91,79
2012 - 2014,55113,55113,2014,2012,0,0,0,0.007,0.019,0.780,13.135,20,20,16580,16515,829,825,13055,13090,652,654,4,2
2014 - 2016,55113,55113,2016,2014,0,0,0,0.007,0.023,0.773,13.076,20,20,16515,16440,825,822,13090,13055,654,652,3,2
2016 - 2018,55113,55113,2018,2016,4,2,2,0.005,0.026,0.767,13.017,20,20,16440,16370,822,818,13055,13070,652,653,4,1
2018 - 2020,55113,55113,2020,2018,0,0,0,0.004,0.028,0.769,13.100,20,20,16370,16475,818,823,13070,13305,653,665,5,12
2020 - 2022,55113,55113,2022,2020,0,0,0,0.006,0.028,0.776,14.357,20,20,16475,18055,823,902,13305,14685,665,734,79,69
2012 - 2014,55115,55115,2014,2012,0,0,0,0.003,0.024,0.877,46.690,34,34,41820,41695,1230,1226,31985,32145,940,945,4,5
2014 - 2016,55115,55115,2016,2014,2,1,1,0.003,0.025,0.874,46.333,34,34,41695,41385,1226,1217,32145,32040,945,942,9,3
2016 - 2018,55115,55115,2018,2016,4,2,2,0.004,0.027,0.869,45.912,34,34,41385,41010,1217,1206,32040,31895,942,938,11,4
2018 - 2020,55115,55115,2020,2018,0,0,0,0.004,0.030,0.865,45.694,34,34,41010,40815,1206,1200,31895,31870,938,937,6,1
2020 - 2022,55115,55115,2022,2020,2,1,1,0.005,0.031,0.861,45.733,34,34,40815,40850,1200,1201,31870,32005,937,941,1,4
2012 - 2014,55117,55117,2014,2012,10,2,8,0.014,0.057,0.864,225.260,44,38,115375,115170,2622,3030,85225,85580,1936,2252,408,316
2014 - 2016,55117,55117,2016,2014,11,4,7,0.015,0.060,0.856,225.455,38,35,115170,115270,3030,3293,85580,86115,2252,2460,263,208
2016 - 2018,55117,55117,2018,2016,0,0,0,0.018,0.062,0.847,225.217,35,35,115270,115205,3293,3291,86115,86875,2460,2482,2,22
2018 - 2020,55117,55117,2020,2018,8,4,4,0.020,0.066,0.837,225.110,35,35,115205,115150,3291,3290,86875,86980,2482,2485,1,3
2020 - 2022,55117,55117,2022,2020,26,14,12,0.019,0.069,0.829,230.177,35,37,115150,117740,3290,3182,86980,89480,2485,2418,108,67
2012 - 2014,55119,55119,2014,2012,0,0,0,0.004,0.017,0.969,21.125,27,27,20630,20595,764,762,15455,15485,572,573,2,1
2014 - 2016,55119,55119,2016,2014,3,1,2,0.004,0.018,0.966,21.045,27,26,20595,20520,762,789,15485,15445,573,594,27,21
2016 - 2018,55119,55119,2018,2016,0,0,0,0.005,0.020,0.960,20.876,26,26,20520,20355,789,782,15445,15305,594,588,7,6
2018 - 2020,55119,55119,2020,2018,0,0,0,0.000,0.023,0.957,20.840,26,26,20355,20320,782,781,15305,15400,588,592,1,4
2020 - 2022,55119,55119,2022,2020,0,0,0,0.002,0.025,0.955,20.491,26,26,20320,19980,781,768,15400,15260,592,586,13,6
2012 - 2014,55121,55121,2014,2012,0,0,0,0.004,0.062,0.921,39.938,26,26,28855,29275,1109,1125,21230,21395,816,822,16,6
2014 - 2016,55121,55121,2016,2014,12,6,6,0.004,0.070,0.911,40.273,26,26,29275,29520,1125,1135,21395,21595,822,830,10,8
2016 - 2018,55121,55121,2018,2016,6,3,3,0.005,0.079,0.900,40.163,26,26,29520,29440,1135,1132,21595,21425,830,824,3,6
2018 - 2020,55121,55121,2020,2018,7,4,3,0.004,0.087,0.892,40.281,26,27,29440,29525,1132,1093,21425,21420,824,793,39,31
2020 - 2022,55121,55121,2022,2020,7,3,4,0.004,0.092,0.887,41.857,27,26,29525,30680,1093,1180,21420,22080,793,849,87,56
2012 - 2014,55123,55123,2014,2012,4,2,2,0.004,0.015,0.967,38.058,29,29,29825,30125,1028,1038,21840,22145,753,763,10,10
2014 - 2016,55123,55123,2016,2014,7,4,3,0.005,0.015,0.965,38.456,29,30,30125,30440,1038,1014,22145,22450,763,748,24,15
2016 - 2018,55123,55123,2018,2016,0,0,0,0.003,0.016,0.963,38.550,30,30,30440,30515,1014,1017,22450,22405,748,746,3,2
2018 - 2020,55123,55123,2020,2018,6,2,4,0.002,0.016,0.963,38.860,30,28,30515,30760,1017,1098,22405,22545,746,805,81,59
2020 - 2022,55123,55123,2022,2020,7,3,4,0.002,0.017,0.961,38.923,28,27,30760,30810,1098,1141,22545,22600,805,837,43,32
2012 - 2014,55125,55125,2014,2012,0,0,0,0.004,0.016,0.860,24.950,15,15,21490,21370,1432,1424,17545,17590,1169,1172,8,3
2014 - 2016,55125,55125,2016,2014,0,0,0,0.001,0.020,0.854,24.921,15,15,21370,21375,1424,1425,17590,17630,1172,1175,1,3
2016 - 2018,55125,55125,2018,2016,6,3,3,0.003,0.025,0.850,25.178,15,15,21375,21595,1425,1439,17630,17915,1175,1194,14,19
2018 - 2020,55125,55125,2020,2018,4,2,2,0.003,0.026,0.852,25.562,15,15,21595,21925,1439,1461,17915,18195,1194,1213,22,19
2020 - 2022,55125,55125,2022,2020,0,0,0,0.005,0.026,0.855,26.985,15,15,21925,23145,1461,1543,18195,19205,1213,1280,82,67
2012 - 2014,55127,55127,2014,2012,2,1,1,0.009,0.107,0.862,185.359,29,29,102310,102920,3527,3548,74950,75750,2584,2612,21,28
2014 - 2016,55127,55127,2016,2014,6,3,3,0.010,0.109,0.859,185.536,29,29,102920,103020,3548,3552,75750,76630,2612,2642,4,30
2016 - 2018,55127,55127,2018,2016,0,0,0,0.009,0.110,0.856,185.467,29,29,103020,103015,3552,3552,76630,77350,2642,2667,0,25
2018 - 2020,55127,55127,2020,2018,12,6,6,0.008,0.112,0.854,186.158,29,29,103015,103390,3552,3565,77350,78930,2667,2721,13,54
2020 - 2022,55127,55127,2022,2020,20,10,10,0.008,0.114,0.852,189.280,29,29,103390,105125,3565,3625,78930,80735,2721,2783,60,62
2012 - 2014,55129,55129,2014,2012,3,2,1,0.005,0.015,0.951,19.803,21,22,15895,15785,756,717,12560,12560,598,570,39,28
2014 - 2016,55129,55129,2016,2014,0,0,0,0.004,0.016,0.947,19.677,22,22,15785,15685,717,712,12560,12625,570,573,5,3
2016 - 2018,55129,55129,2018,2016,1,1,0,0.004,0.018,0.944,19.684,22,23,15685,15690,712,682,12625,12610,573,548,30,25
2018 - 2020,55129,55129,2020,2018,2,1,1,0.003,0.018,0.943,19.727,23,23,15690,15725,682,683,12610,12680,548,551,1,3
2020 - 2022,55129,55129,2022,2020,3,2,1,0.002,0.019,0.942,20.932,23,24,15725,16685,683,695,12680,13505,551,562,12,11
2012 - 2014,55131,55131,2014,2012,2,1,1,0.010,0.028,0.939,307.745,32,32,131840,132525,4120,4141,98460,99925,3076,3122,21,46
2014 - 2016,55131,55131,2016,2014,6,3,3,0.011,0.030,0.935,309.813,32,32,132525,133420,4141,4169,99925,101285,3122,3165,28,43
2016 - 2018,55131,55131,2018,2016,4,2,2,0.012,0.031,0.931,312.404,32,32,133420,134535,4169,4204,101285,103060,3165,3220,35,55
2018 - 2020,55131,55131,2020,2018,6,2,4,0.014,0.033,0.926,314.715,32,30,134535,135530,4204,4517,103060,104555,3220,3485,313,265
2020 - 2022,55131,55131,2022,2020,17,9,8,0.014,0.034,0.921,317.757,30,31,135530,136840,4517,4414,104555,106415,3485,3432,103,53
2012 - 2014,55133,55133,2014,2012,11,4,7,0.013,0.044,0.900,714.169,93,90,389740,392510,4190,4361,289735,293815,3115,3264,171,149
2014 - 2016,55133,55133,2016,2014,15,7,8,0.014,0.045,0.895,719.281,90,89,392510,395375,4361,4442,293815,298750,3264,3356,81,92
2016 - 2018,55133,55133,2018,2016,22,11,11,0.016,0.046,0.888,725.605,89,89,395375,398880,4442,4481,298750,303330,3356,3408,39,52
2018 - 2020,55133,55133,2020,2018,49,18,31,0.015,0.049,0.881,732.436,89,76,398880,402635,4481,5297,303330,307645,3408,4047,816,639
2020 - 2022,55133,55133,2022,2020,67,36,31,0.016,0.051,0.874,740.904,76,81,402635,407290,5297,5028,307645,312905,4047,3863,269,184
2012 - 2014,55135,55135,2014,2012,9,5,4,0.004,0.027,0.952,69.835,36,37,52375,52210,1454,1411,40230,40310,1117,1089,43,28
2014 - 2016,55135,55135,2016,2014,14,7,7,0.004,0.029,0.949,69.513,37,37,52210,51975,1411,1404,40310,40340,1089,1090,7,1
2016 - 2018,55135,55135,2018,2016,7,3,4,0.004,0.031,0.945,68.805,37,36,51975,51445,1404,1429,40340,40165,1090,1115,25,25
2018 - 2020,55135,55135,2020,2018,11,5,6,0.006,0.032,0.943,68.203,36,35,51445,50995,1429,1457,40165,40015,1115,1143,28,28
2020 - 2022,55135,55135,2022,2020,1,0,1,0.007,0.034,0.940,69.306,35,34,50995,51820,1457,1524,40015,41005,1143,1206,67,63
2012 - 2014,55137,55137,2014,2012,0,0,0,0.019,0.060,0.903,38.982,21,21,24565,24410,1169,1162,19435,19425,925,925,7,0
2014 - 2016,55137,55137,2016,2014,2,1,1,0.015,0.062,0.899,38.712,21,21,24410,24240,1162,1154,19425,19255,925,916,8,9
2016 - 2018,55137,55137,2018,2016,3,1,2,0.018,0.063,0.897,38.513,21,20,24240,24115,1154,1205,19255,19215,916,960,51,44
2018 - 2020,55137,55137,2020,2018,1,1,0,0.016,0.065,0.895,38.736,20,21,24115,24255,1205,1155,19215,19570,960,931,50,29
2020 - 2022,55137,55137,2022,2020,0,0,0,0.019,0.065,0.894,39.399,21,21,24255,24670,1155,1174,19570,19940,931,949,19,18
2012 - 2014,55139,55139,2014,2012,1,1,0,0.017,0.037,0.901,387.618,50,51,166985,168415,3339,3302,128400,130505,2568,2558,37,10
2014 - 2016,55139,55139,2016,2014,8,3,5,0.020,0.038,0.896,390.081,51,49,168415,169485,3302,3458,130505,131605,2558,2685,156,127
2016 - 2018,55139,55139,2018,2016,20,10,10,0.022,0.040,0.890,390.909,49,49,169485,169925,3458,3467,131605,132075,2685,2695,9,10
2018 - 2020,55139,55139,2020,2018,19,7,12,0.023,0.042,0.882,393.205,49,44,169925,170925,3467,3884,132075,133410,2695,3032,417,337
2020 - 2022,55139,55139,2022,2020,49,25,24,0.025,0.045,0.874,393.826,44,45,170925,171195,3884,3804,133410,134245,3032,2983,80,49
2012 - 2014,55141,55141,2014,2012,1,0,1,0.005,0.025,0.935,93.650,35,34,74590,74260,2131,2184,56965,57055,1627,1678,53,51
2014 - 2016,55141,55141,2016,2014,6,3,3,0.007,0.027,0.931,92.844,34,34,74260,73620,2184,2165,57055,56800,1678,1670,19,8
2016 - 2018,55141,55141,2018,2016,7,3,4,0.006,0.029,0.926,92.401,34,33,73620,73275,2165,2220,56800,56565,1670,1714,55,44
2018 - 2020,55141,55141,2020,2018,6,4,2,0.008,0.032,0.921,91.912,33,35,73275,72890,2220,2082,56565,56305,1714,1608,138,106
2020 - 2022,55141,55141,2022,2020,0,0,0,0.007,0.034,0.918,93.488,35,35,72890,74140,2082,2118,56305,57470,1608,1642,36,34
